christmas	christmas	PROPN	Number=Sing
25	25	NUM	NumType=Card
party	party	NOUN	Number=Sing
Sun	Sun	PROPN	Number=Sing
am	am	NOUN	Number=Sing
am	be	AUX	Mood=Ind|Number=Sing|Person=1|Tense=Pres|VerbForm=Fin
Archibald	Archibald	PROPN	Number=Sing
passed	pass	VERB	Mood=Ind|Tense=Past|VerbForm=Fin
rabbits	rabbit	NOUN	Number=Plur
offers	offer	VERB	Mood=Ind|Number=Sing|Person=3|Tense=Pres|VerbForm=Fin
articles	article	NOUN	Number=Plur
El	El	PROPN	Number=Sing
Yet	yet	CCONJ	_
Sufaat	Sufaat	PROPN	Number=Sing
creates	create	VERB	Mood=Ind|Number=Sing|Person=3|Tense=Pres|VerbForm=Fin
century	century	NOUN	Number=Sing
exception	exception	NOUN	Number=Sing
Honda	Honda	PROPN	Number=Sing
facility	facility	NOUN	Number=Sing
closed	close	VERB	Mood=Ind|Tense=Past|VerbForm=Fin
Services	service	NOUN	Number=Plur
?!	?!	PUNCT	_
technical	technical	ADJ	Degree=Pos
1968	1968	NUM	NumType=Card
Rome	Rome	PROPN	Number=Sing
president	president	PROPN	Number=Sing
president	president	NOUN	Number=Sing
enough	enough	ADJ	Degree=Pos
enough	enough	ADV	_
PaineWebber	PaineWebber	PROPN	Number=Sing
friendly	friendly	ADJ	Degree=Pos
rates	rate	NOUN	Number=Plur
laptop	laptop	NOUN	Number=Sing
E17	E17	PROPN	Number=Sing
Posted	post	VERB	Tense=Past|VerbForm=Part
Though	though	SCONJ	_
wall	wall	NOUN	Number=Sing
received	receive	VERB	Tense=Past|VerbForm=Part|Voice=Pass
received	receive	VERB	Tense=Past|VerbForm=Part
received	receive	VERB	Mood=Ind|Tense=Past|VerbForm=Fin
add	add	VERB	Mood=Imp|VerbForm=Fin
add	add	VERB	VerbForm=Inf
street	street	NOUN	Number=Sing
Jihad	Jihad	PROPN	Number=Sing
training	training	NOUN	Number=Sing
cheaper	cheaper	ADJ	Degree=Cmp
lesson	lesson	NOUN	Number=Sing
Pacific	Pacific	PROPN	Number=Sing
inflation	inflation	NOUN	Number=Sing
communication	communication	NOUN	Number=Sing
milk	milk	NOUN	Number=Sing
would	would	AUX	VerbForm=Fin
approval	approval	NOUN	Number=Sing
African	african	ADJ	Degree=Pos
for	for	CCONJ	_
for	for	SCONJ	_
for	for	ADP	_
minimum	minimum	NOUN	Number=Sing
minimum	minimum	ADJ	Degree=Pos
Perlingiere	Perlingiere	PROPN	Number=Sing
within	within	ADP	_
producers	producer	NOUN	Number=Plur
tent	tent	NOUN	Number=Sing
New	new	ADJ	Degree=Pos
New	New	PROPN	Number=Sing
version	version	NOUN	Number=Sing
31	31	NUM	NumType=Card
Islamic	Islamic	PROPN	Number=Sing
Islamic	islamic	ADJ	Degree=Pos
cafeteria	cafeteria	NOUN	Number=Sing
travel	travel	NOUN	Number=Sing
travel	travel	VERB	VerbForm=Inf
01/24/2001	01/24/2001	NUM	NumType=Card
thorough	thorough	ADJ	Degree=Pos
Fax	fax	NOUN	Number=Sing
gay	gay	ADJ	Degree=Pos
initial	initial	VERB	VerbForm=Inf
initial	initial	ADJ	Degree=Pos
Both	both	CCONJ	_
Both	both	DET	_
Earth	Earth	PROPN	Number=Sing
ton	ton	NOUN	Number=Sing
way	way	NOUN	Number=Sing
way	way	ADV	_
Bush	Bush	PROPN	Number=Sing
80's	80'	NOUN	Number=Plur
process	process	NOUN	Number=Sing
Really	really	ADV	_
22	22	NUM	NumType=Card
rocket	rocket	NOUN	Number=Sing
Sheridan	Sheridan	PROPN	Number=Sing
vehicles	vehicle	NOUN	Number=Plur
magic	magic	NOUN	Number=Sing
tests	test	NOUN	Number=Plur
parent	parent	NOUN	Number=Sing
population	population	NOUN	Number=Sing
hours	hour	NOUN	Number=Plur
removed	remove	VERB	Tense=Past|VerbForm=Part|Voice=Pass
vote	vote	VERB	VerbForm=Inf
vote	vote	NOUN	Number=Sing
ago	ago	ADV	_
adventure	adventure	NOUN	Number=Sing
pattern	pattern	NOUN	Number=Sing
bear	bear	NOUN	Number=Sing
smart	smart	ADJ	Degree=Pos
chain	chain	NOUN	Number=Sing
afford	afford	VERB	VerbForm=Inf
Mississippi	Mississippi	PROPN	Number=Sing
cancer	cancer	NOUN	Number=Sing
myself	myself	PRON	Number=Sing|Person=1|PronType=Prs
myself	myself	PRON	Case=Acc|Number=Sing|Person=1|PronType=Prs|Reflex=Yes
Lennon	Lennon	PROPN	Number=Sing
threats	threat	NOUN	Number=Plur
..	..	PUNCT	_
besides	besides	ADP	_
dealer	dealer	NOUN	Number=Sing
Valley	Valley	PROPN	Number=Sing
affected	affect	VERB	Tense=Past|VerbForm=Part
mold	mold	NOUN	Number=Sing
arms	arm	NOUN	Number=Plur
attorneys	attorney	NOUN	Number=Plur
7:00	7:00	NUM	NumType=Card
Alito	Alito	PROPN	Number=Sing
boys	boy	NOUN	Number=Plur
snakes	snake	NOUN	Number=Plur
hard	hard	ADV	Degree=Pos
hard	hard	ADJ	Degree=Pos
holiday	holiday	NOUN	Number=Sing
Per	per	ADP	_
Per	Per	PROPN	Number=Sing
Del	Del	PROPN	Number=Sing
possible	possible	ADJ	Degree=Pos
nervous	nervous	ADJ	Degree=Pos
higher	higher	ADJ	Degree=Cmp
bike	bike	NOUN	Number=Sing
means	mean	VERB	Mood=Ind|Number=Sing|Person=3|Tense=Pres|VerbForm=Fin
means	means	NOUN	Number=Plur
CIA	CIA	PROPN	Number=Sing
Carolina	Carolina	PROPN	Number=Sing
found	find	VERB	Tense=Past|VerbForm=Part
found	find	VERB	Tense=Past|VerbForm=Part|Voice=Pass
found	find	VERB	Mood=Ind|Tense=Past|VerbForm=Fin
starts	start	VERB	Mood=Ind|Number=Sing|Person=3|Tense=Pres|VerbForm=Fin
evidence	evidence	NOUN	Number=Sing
charged	charge	VERB	Mood=Ind|Tense=Past|VerbForm=Fin
charged	charge	VERB	Tense=Past|VerbForm=Part
charged	charge	VERB	Tense=Past|VerbForm=Part|Voice=Pass
mission	mission	NOUN	Number=Sing
error	error	NOUN	Number=Sing
effort	effort	NOUN	Number=Sing
coming	come	VERB	VerbForm=Ger
coming	come	VERB	Tense=Pres|VerbForm=Part
dining	dining	NOUN	Number=Sing
records	record	NOUN	Number=Plur
transportation	transportation	NOUN	Number=Sing
show	show	VERB	VerbForm=Inf
show	show	NOUN	Number=Sing
show	show	VERB	Mood=Ind|Tense=Pres|VerbForm=Fin
cuts	cut	NOUN	Number=Plur
Jeff	Jeff	PROPN	Number=Sing
sake	sake	NOUN	Number=Sing
etc	etc	X	_
trader	trader	NOUN	Number=Sing
place	place	NOUN	Number=Sing
place	place	VERB	Mood=Imp|VerbForm=Fin
place	place	VERB	VerbForm=Inf
Game	game	NOUN	Number=Sing
46	46	NUM	NumType=Card
weeks	week	NOUN	Number=Plur
200	200	NUM	NumType=Card
Prime	Prime	PROPN	Number=Sing
airline	airline	NOUN	Number=Sing
Harrison	Harrison	PROPN	Number=Sing
your	you	PRON	Person=2|Poss=Yes|PronType=Prs
01/12/2001	01/12/2001	NUM	NumType=Card
refer	refer	VERB	VerbForm=Inf
refer	refer	VERB	Mood=Ind|Tense=Pres|VerbForm=Fin
choice	choice	NOUN	Number=Sing
speaking	speak	VERB	VerbForm=Ger
Rahman	Rahman	PROPN	Number=Sing
biological	biological	ADJ	Degree=Pos
cover	cover	NOUN	Number=Sing
cover	cover	VERB	VerbForm=Inf
UN	UN	PROPN	Number=Sing
Do	do	VERB	Mood=Imp|VerbForm=Fin
Do	do	AUX	Mood=Imp|VerbForm=Fin
Do	do	AUX	Mood=Ind|Tense=Pres|VerbForm=Fin
Do	do	AUX	VerbForm=Inf
twice	twice	ADV	NumType=Mult
Taliban	Taliban	PROPN	Number=Sing
detailed	detailed	ADJ	Degree=Pos
forget	forget	VERB	Mood=Imp|VerbForm=Fin
forget	forget	VERB	VerbForm=Inf
Devil	Devil	PROPN	Number=Sing
exposure	exposure	NOUN	Number=Sing
Guard	Guard	PROPN	Number=Sing
assault	assault	NOUN	Number=Sing
filter	filter	NOUN	Number=Sing
Dave	Dave	PROPN	Number=Sing
expect	expect	VERB	Mood=Ind|Tense=Pres|VerbForm=Fin
expect	expect	VERB	VerbForm=Inf
Colombo	Colombo	PROPN	Number=Sing
weapon	weapon	NOUN	Number=Sing
man	man	NOUN	Number=Sing
from	from	SCONJ	_
from	from	ADP	_
satisfy	satisfy	VERB	VerbForm=Inf
16	16	NUM	NumType=Card
asymmetrical	asymmetrical	ADJ	Degree=Pos
types	type	NOUN	Number=Plur
effect	effect	NOUN	Number=Sing
Almost	almost	ADV	_
Full	full	ADJ	Degree=Pos
guidelines	guideline	NOUN	Number=Plur
cleaning	clean	VERB	VerbForm=Ger
Perfect	perfect	ADJ	Degree=Pos
destruction	destruction	NOUN	Number=Sing
Reply	reply	VERB	Mood=Imp|VerbForm=Fin
bit	bit	NOUN	Number=Sing
Thane	Thane	PROPN	Number=Sing
takes	take	VERB	Mood=Ind|Number=Sing|Person=3|Tense=Pres|VerbForm=Fin
driving	drive	VERB	VerbForm=Ger
honestly	honestly	ADV	_
requirements	requirement	NOUN	Number=Plur
led	lead	VERB	Tense=Past|VerbForm=Part
led	lead	VERB	Mood=Ind|Tense=Past|VerbForm=Fin
second	second	ADJ	Degree=Pos|NumType=Ord
second	second	ADV	_
post	post	VERB	VerbForm=Inf
post	post	NOUN	Number=Sing
reliable	reliable	ADJ	Degree=Pos
Plus	plus	CCONJ	_
places	place	NOUN	Number=Plur
choose	choose	VERB	Mood=Ind|Tense=Pres|VerbForm=Fin
choose	choose	VERB	VerbForm=Inf
Blair	Blair	PROPN	Number=Sing
especially	especially	ADV	_
Afghan	afghan	ADJ	Degree=Pos
owners	owner	NOUN	Number=Plur
Gerry	Gerry	PROPN	Number=Sing
tonight	tonight	NOUN	Number=Sing
honest	honest	ADJ	Degree=Pos
towns	town	NOUN	Number=Plur
willing	willing	ADJ	Degree=Pos
awful	awful	ADJ	Degree=Pos
reply	reply	NOUN	Number=Sing
Hospital	Hospital	PROPN	Number=Sing
raised	raise	VERB	Tense=Past|VerbForm=Part
raised	raise	VERB	Tense=Past|VerbForm=Part|Voice=Pass
five	five	NUM	NumType=Card
election	election	NOUN	Number=Sing
software	software	NOUN	Number=Sing
person	person	NOUN	Number=Sing
watching	watch	VERB	VerbForm=Ger
waiting	wait	VERB	Tense=Pres|VerbForm=Part
waiting	waiting	NOUN	Number=Sing
waiting	wait	VERB	VerbForm=Ger
guaranty	guaranty	NOUN	Number=Sing
hot	hot	ADJ	Degree=Pos
BUT	but	CCONJ	_
Jan	Jan	PROPN	Number=Sing
discount	discount	NOUN	Number=Sing
wolf	wolf	NOUN	Number=Sing
good	good	NOUN	Number=Sing
good	good	ADJ	Degree=Pos
locations	location	NOUN	Number=Plur
mention	mention	VERB	VerbForm=Inf
lab	lab	NOUN	Number=Sing
powerful	powerful	ADJ	Degree=Pos
paying	pay	VERB	Tense=Pres|VerbForm=Part
paying	pay	VERB	VerbForm=Ger
computer	computer	NOUN	Number=Sing
false	false	ADJ	Degree=Pos
basically	basically	ADV	_
Brooklyn	Brooklyn	PROPN	Number=Sing
Secretary	Secretary	PROPN	Number=Sing
manner	manner	NOUN	Number=Sing
peaceful	peaceful	ADJ	Degree=Pos
29	29	NUM	NumType=Card
11/28/2000	11/28/2000	NUM	NumType=Card
Muslim	muslim	ADJ	Degree=Pos
leader	leader	NOUN	Number=Sing
once	once	ADV	NumType=Mult
once	once	SCONJ	_
open	open	VERB	VerbForm=Inf
open	open	ADJ	Degree=Pos
aware	aware	ADJ	Degree=Pos
court	court	NOUN	Number=Sing
rockets	rocket	NOUN	Number=Plur
BTA	BTA	PROPN	Number=Sing
??	??	PUNCT	_
sample	sample	NOUN	Number=Sing
coalition	coalition	NOUN	Number=Sing
we	we	PRON	Case=Nom|Number=Plur|Person=1|PronType=Prs
Jones	Jones	PROPN	Number=Sing
kinda	kinda	ADV	_
personality	personality	NOUN	Number=Sing
pass	pass	VERB	VerbForm=Inf
grounds	grounds	NOUN	Number=Plur
residents	resident	NOUN	Number=Plur
draft	draft	NOUN	Number=Sing
sitting	sit	VERB	VerbForm=Ger
sitting	sit	VERB	Tense=Pres|VerbForm=Part
completely	completely	ADV	_
warn	warn	VERB	VerbForm=Inf
tail	tail	NOUN	Number=Sing
London	London	PROPN	Number=Sing
allegations	allegation	NOUN	Number=Plur
fries	fries	NOUN	Number=Plur
girls	girl	NOUN	Number=Plur
compared	compare	VERB	Tense=Past|VerbForm=Part
September	September	PROPN	Number=Sing
looking	look	VERB	Tense=Pres|VerbForm=Part
looking	look	VERB	VerbForm=Ger
spokesman	spokesman	NOUN	Number=Sing
Pizza	Pizza	PROPN	Number=Sing
responsibilities	responsibility	NOUN	Number=Plur
THE	the	DET	Definite=Def|PronType=Art
own	own	VERB	Mood=Ind|Tense=Pres|VerbForm=Fin
own	own	ADJ	Degree=Pos
variety	variety	NOUN	Number=Sing
E.	E.	PROPN	Number=Sing
inner	inner	ADJ	Degree=Pos
ON	on	ADP	_
Jews	Jews	PROPN	Number=Plur
Tamil	Tamil	PROPN	Number=Sing
Syria	Syria	PROPN	Number=Sing
southern	southern	ADJ	Degree=Pos
Club	Club	PROPN	Number=Sing
fear	fear	NOUN	Number=Sing
media	media	NOUN	Number=Sing
bringing	bring	VERB	VerbForm=Ger
quote	quote	NOUN	Number=Sing
Before	before	SCONJ	_
many	many	ADJ	Degree=Pos
hurt	hurt	VERB	VerbForm=Inf
absolutely	absolutely	ADV	_
reminder	reminder	NOUN	Number=Sing
largely	largely	ADV	_
shares	share	NOUN	Number=Plur
July	July	PROPN	Number=Sing
unsure	unsure	ADJ	Degree=Pos
23rd	23rd	NOUN	Number=Sing
William	William	PROPN	Number=Sing
pets	pet	NOUN	Number=Plur
feeding	feeding	NOUN	Number=Sing
feeding	feed	VERB	VerbForm=Ger
bottom	bottom	NOUN	Number=Sing
Only	only	ADV	_
apart	apart	ADV	_
recommended	recommend	VERB	Mood=Ind|Tense=Past|VerbForm=Fin
recommended	recommend	VERB	Tense=Past|VerbForm=Part
latest	latest	ADJ	Degree=Sup
opportunity	opportunity	NOUN	Number=Sing
argument	argument	NOUN	Number=Sing
however	however	ADV	_
portion	portion	NOUN	Number=Sing
p.m	p.m	NOUN	Number=Sing
accessibility	accessibility	NOUN	Number=Sing
utilities	utility	NOUN	Number=Plur
bowl	bowl	NOUN	Number=Sing
initially	initially	ADV	_
compete	compete	VERB	VerbForm=Inf
More	more	ADV	_
More	more	ADJ	Degree=Cmp
effective	effective	ADJ	Degree=Pos
suffer	suffer	VERB	Mood=Ind|Tense=Pres|VerbForm=Fin
suffer	suffer	VERB	VerbForm=Inf
Lanka	Lanka	PROPN	Number=Sing
request	request	NOUN	Number=Sing
request	request	VERB	VerbForm=Inf
Legal	Legal	PROPN	Number=Sing
Legal	legal	ADJ	Degree=Pos
educational	educational	ADJ	Degree=Pos
Ben	Ben	PROPN	Number=Sing
passport	passport	NOUN	Number=Sing
avoid	avoid	VERB	VerbForm=Inf
hope	hope	NOUN	Number=Sing
hope	hope	VERB	Mood=Ind|Tense=Pres|VerbForm=Fin
regret	regret	VERB	VerbForm=Inf
suggestion	suggestion	NOUN	Number=Sing
established	establish	VERB	Tense=Past|VerbForm=Part|Voice=Pass
established	establish	VERB	Tense=Past|VerbForm=Part
talk	talk	VERB	VerbForm=Inf
talk	talk	VERB	Mood=Ind|Tense=Pres|VerbForm=Fin
talk	talk	NOUN	Number=Sing
hijackers	hijacker	NOUN	Number=Plur
November	November	PROPN	Number=Sing
excited	excited	ADJ	Degree=Pos
tea	tea	NOUN	Number=Sing
capacity	capacity	NOUN	Number=Sing
option	option	NOUN	Number=Sing
heard	hear	VERB	Mood=Ind|Tense=Past|VerbForm=Fin
heard	hear	VERB	Tense=Past|VerbForm=Part
remove	remove	VERB	VerbForm=Inf
23	23	NUM	NumType=Card
Turbine	turbine	NOUN	Number=Sing
that	that	ADV	PronType=Dem
that	that	ADV	PronType=Rel
that	that	ADV	_
that	that	DET	Number=Sing|PronType=Dem
that	that	PRON	PronType=Rel
that	that	PRON	PronType=Dem
that	that	PRON	Number=Sing|PronType=Dem
that	that	SCONJ	_
elections	election	NOUN	Number=Plur
Remember	remember	VERB	Mood=Imp|VerbForm=Fin
Is	be	VERB	Mood=Ind|Number=Sing|Person=3|Tense=Pres|VerbForm=Fin
Is	be	AUX	Mood=Ind|Number=Sing|Person=3|Tense=Pres|VerbForm=Fin
matter	matter	NOUN	Number=Sing
matter	matter	ADV	_
matter	matter	VERB	VerbForm=Inf
Okay	okay	INTJ	_
ideation	ideation	NOUN	Number=Sing
Hope	hope	VERB	Mood=Ind|Tense=Pres|VerbForm=Fin
Supreme	Supreme	PROPN	Number=Sing
Jewish	jewish	ADJ	Degree=Pos
Brazil	Brazil	PROPN	Number=Sing
six	six	NUM	NumType=Card
painful	painful	ADJ	Degree=Pos
Money	money	NOUN	Number=Sing
UK	UK	PROPN	Number=Sing
promised	promise	VERB	Tense=Past|VerbForm=Part
various	various	ADJ	Degree=Pos
upper	upper	ADJ	Degree=Pos
rest	rest	NOUN	Number=Sing
kitten	kitten	NOUN	Number=Sing
tomorrow	tomorrow	NOUN	Number=Sing
political	political	ADJ	Degree=Pos
understand	understand	VERB	VerbForm=Inf
understand	understand	VERB	Mood=Ind|Tense=Pres|VerbForm=Fin
clearly	clearly	ADV	_
Kalkat	Kalkat	PROPN	Number=Sing
ground	ground	NOUN	Number=Sing
hassle	hassle	NOUN	Number=Sing
article	article	NOUN	Number=Sing
clients	client	NOUN	Number=Plur
priced	priced	ADJ	Degree=Pos
Keep	keep	VERB	Mood=Imp|VerbForm=Fin
9:30	9:30	NUM	NumType=Card
liberty	liberty	NOUN	Number=Sing
collection	collection	NOUN	Number=Sing
Communist	Communist	PROPN	Number=Sing
eyes	eye	NOUN	Number=Plur
doing	do	VERB	Tense=Pres|VerbForm=Part
doing	do	VERB	VerbForm=Ger
dogs	dog	NOUN	Number=Plur
Chris	Chris	PROPN	Number=Sing
ongoing	ongoing	ADJ	Degree=Pos
hole	hole	NOUN	Number=Sing
problem	problem	NOUN	Number=Sing
happy	happy	ADJ	Degree=Pos
clerics	cleric	NOUN	Number=Plur
Dale	Dale	PROPN	Number=Sing
external	external	ADJ	Degree=Pos
confidential	confidential	ADJ	Degree=Pos
himself	himself	PRON	Case=Acc|Gender=Masc|Number=Sing|Person=3|PronType=Prs|Reflex=Yes
planes	plane	NOUN	Number=Plur
PM	pm	NOUN	Number=Sing
gains	gain	NOUN	Number=Plur
Your	you	PRON	Person=2|Poss=Yes|PronType=Prs
Post	Post	PROPN	Number=Sing
Okinawa	Okinawa	PROPN	Number=Sing
Four	four	NUM	NumType=Card
garage	garage	NOUN	Number=Sing
press	press	NOUN	Number=Sing
innocent	innocent	ADJ	Degree=Pos
making	make	VERB	VerbForm=Ger
making	making	NOUN	Number=Sing
making	make	VERB	Tense=Pres|VerbForm=Part
surprise	surprise	NOUN	Number=Sing
could	could	AUX	VerbForm=Fin
close	close	ADJ	Degree=Pos
close	close	ADV	Degree=Pos
close	close	VERB	Mood=Ind|Tense=Pres|VerbForm=Fin
close	close	VERB	VerbForm=Inf
close	close	NOUN	Number=Sing
expectations	expectation	NOUN	Number=Plur
provision	provision	NOUN	Number=Sing
beers	beer	NOUN	Number=Plur
Robert	Robert	PROPN	Number=Sing
salon	salon	NOUN	Number=Sing
humans	human	NOUN	Number=Plur
units	unit	NOUN	Number=Plur
include	include	VERB	Mood=Ind|Tense=Pres|VerbForm=Fin
include	include	VERB	VerbForm=Inf
Oh	oh	INTJ	_
3.5	3.5	NUM	NumType=Card
Kim	Kim	PROPN	Number=Sing
babies	baby	NOUN	Number=Plur
beginning	beginning	NOUN	Number=Sing
beginning	begin	VERB	VerbForm=Ger
grow	grow	VERB	VerbForm=Inf
40	40	NUM	NumType=Card
reflects	reflect	VERB	Mood=Ind|Number=Sing|Person=3|Tense=Pres|VerbForm=Fin
Iran	Iran	PROPN	Number=Sing
apparently	apparently	ADV	_
firm	firm	NOUN	Number=Sing
Vietnam	Vietnam	PROPN	Number=Sing
Sunni	sunni	ADJ	Degree=Pos
blown	blow	VERB	Tense=Past|VerbForm=Part
mile	mile	NOUN	Number=Sing
These	these	DET	Number=Plur|PronType=Dem
These	these	PRON	Number=Plur|PronType=Dem
raise	raise	VERB	VerbForm=Inf
challenges	challenge	NOUN	Number=Plur
strengthen	strengthen	VERB	VerbForm=Inf
reflect	reflect	VERB	VerbForm=Inf
crew	crew	NOUN	Number=Sing
group	group	NOUN	Number=Sing
Marie	Marie	PROPN	Number=Sing
via	via	ADP	_
cheap	cheap	ADJ	Degree=Pos
specific	specific	ADJ	Degree=Pos
courses	course	NOUN	Number=Plur
possibilities	possibility	NOUN	Number=Plur
peninsula	peninsula	NOUN	Number=Sing
events	event	NOUN	Number=Plur
machine	machine	NOUN	Number=Sing
Consciousness	consciousness	NOUN	Number=Sing
aspect	aspect	NOUN	Number=Sing
climate	climate	NOUN	Number=Sing
11:30	11:30	NUM	NumType=Card
made	make	VERB	Tense=Past|VerbForm=Part|Voice=Pass
made	make	VERB	Mood=Ind|Tense=Past|VerbForm=Fin
made	make	VERB	Tense=Past|VerbForm=Part
present	present	ADJ	Degree=Pos
present	present	VERB	VerbForm=Inf
1999	1999	NUM	NumType=Card
due	due	ADP	_
due	due	ADJ	Degree=Pos
bad	bad	ADJ	Degree=Pos
Justin	Justin	PROPN	Number=Sing
mental	mental	ADJ	Degree=Pos
Thai	thai	ADJ	Degree=Pos
Rooms	room	NOUN	Number=Plur
fuel	fuel	NOUN	Number=Sing
Sheikh	Sheikh	PROPN	Number=Sing
new	new	ADJ	Degree=Pos
dates	date	NOUN	Number=Plur
sit	sit	VERB	Mood=Ind|Tense=Pres|VerbForm=Fin
sit	sit	VERB	VerbForm=Inf
goods	goods	NOUN	Number=Plur
kind	kind	NOUN	Number=Sing
kind	kind	ADV	_
kind	kind	ADJ	Degree=Pos
level	level	NOUN	Number=Sing
grown	grow	VERB	Tense=Past|VerbForm=Part
comes	come	VERB	Mood=Ind|Number=Sing|Person=3|Tense=Pres|VerbForm=Fin
tours	tour	NOUN	Number=Plur
statements	statement	NOUN	Number=Plur
alt.animals.cat	alt.animals.cat	NOUN	Number=Sing
line	line	NOUN	Number=Sing
1.5	1.5	NUM	NumType=Card
chemical	chemical	ADJ	Degree=Pos
wedding	wedding	NOUN	Number=Sing
sections	section	NOUN	Number=Plur
SS	ss	NOUN	Number=Sing
EPC	epc	NOUN	Number=Sing
depends	depend	VERB	Mood=Ind|Number=Sing|Person=3|Tense=Pres|VerbForm=Fin
financial	financial	ADJ	Degree=Pos
using	use	VERB	Tense=Pres|VerbForm=Part
using	use	VERB	VerbForm=Ger
nor	nor	CCONJ	_
WILL	will	AUX	VerbForm=Fin
PERFORMANCE	performance	NOUN	Number=Sing
ElPaso	ElPaso	PROPN	Number=Sing
paper	paper	NOUN	Number=Sing
Kam	Kam	PROPN	Number=Sing
unity	unity	NOUN	Number=Sing
parents	parent	NOUN	Number=Plur
'	's	PART	_
'	'	NOUN	Number=Plur
'	'	PUNCT	_
he	he	PRON	Case=Nom|Gender=Masc|Number=Sing|Person=3|PronType=Prs
i.e.	i.e.	X	_
A	a	DET	Definite=Ind|PronType=Art
A	a	SYM	_
A	a	NOUN	Number=Sing
A	A	PROPN	Number=Sing
A	a	X	_
Time	time	NOUN	Number=Sing
Time	Time	PROPN	Number=Sing
cool	cool	ADJ	Degree=Pos
medium	medium	NOUN	Number=Sing
attempts	attempt	NOUN	Number=Plur
ball	ball	NOUN	Number=Sing
smaller	smaller	ADJ	Degree=Cmp
posted	post	VERB	Tense=Past|VerbForm=Part
posted	post	VERB	Tense=Past|VerbForm=Part|Voice=Pass
discussions	discussion	NOUN	Number=Plur
sort	sort	NOUN	Number=Sing
Indian	indian	ADJ	Degree=Pos
pretty	pretty	ADV	_
HERE	here	ADV	PronType=Dem
Dec.	Dec.	PROPN	Number=Sing
penny	penny	NOUN	Number=Sing
vital	vital	ADJ	Degree=Pos
:(	:(	SYM	_
politics	politics	NOUN	Number=Plur
touch	touch	NOUN	Number=Sing
touch	touch	VERB	VerbForm=Inf
Dow	Dow	PROPN	Number=Sing
anywhere	anywhere	ADV	_
play	play	VERB	Mood=Ind|Tense=Pres|VerbForm=Fin
play	play	NOUN	Number=Sing
play	play	VERB	VerbForm=Inf
Check	check	VERB	Mood=Imp|VerbForm=Fin
Well	well	ADV	Degree=Pos
Well	well	INTJ	_
confirming	confirm	VERB	VerbForm=Ger
pricing	pricing	NOUN	Number=Sing
Subject	subject	NOUN	Number=Sing
Orleans	Orleans	PROPN	Number=Sing
moment	moment	NOUN	Number=Sing
Iguazu	Iguazu	PROPN	Number=Sing
Rolling	Rolling	PROPN	Number=Sing
Executive	Executive	PROPN	Number=Sing
Executive	executive	ADJ	Degree=Pos
Constitution	constitution	NOUN	Number=Sing
extra	extra	ADJ	Degree=Pos
taken	take	VERB	Tense=Past|VerbForm=Part|Voice=Pass
taken	take	VERB	Tense=Past|VerbForm=Part
force	force	VERB	VerbForm=Inf
force	force	NOUN	Number=Sing
claim	claim	VERB	Mood=Ind|Tense=Pres|VerbForm=Fin
claim	claim	NOUN	Number=Sing
gets	get	VERB	Mood=Ind|Number=Sing|Person=3|Tense=Pres|VerbForm=Fin
weight	weight	NOUN	Number=Sing
1970s	1970	NOUN	Number=Plur
territory	territory	NOUN	Number=Sing
funded	fund	VERB	Tense=Past|VerbForm=Part|Voice=Pass
48	48	NUM	NumType=Card
bacon	bacon	NOUN	Number=Sing
NZ	NZ	PROPN	Number=Sing
By	by	ADP	_
settle	settle	VERB	VerbForm=Inf
Ruth	Ruth	PROPN	Number=Sing
<<	<<	PUNCT	_
everyone	everyone	PRON	Number=Sing
jihad	jihad	NOUN	Number=Sing
argue	argue	VERB	VerbForm=Inf
agency	agency	NOUN	Number=Sing
join	join	VERB	VerbForm=Inf
horses	horse	NOUN	Number=Plur
tires	tire	NOUN	Number=Plur
lay	lay	VERB	VerbForm=Inf
SJ	sj	NOUN	Number=Sing
activities	activity	NOUN	Number=Plur
the	the	DET	Definite=Def|PronType=Art
the	the	PRON	_
neighbors	neighbor	NOUN	Number=Plur
upcoming	upcoming	ADJ	Degree=Pos
asked	ask	VERB	Tense=Past|VerbForm=Part
asked	ask	VERB	Mood=Ind|Tense=Past|VerbForm=Fin
Bob	Bob	PROPN	Number=Sing
football	football	NOUN	Number=Sing
expressed	express	VERB	Tense=Past|VerbForm=Part
believes	believe	VERB	Mood=Ind|Number=Sing|Person=3|Tense=Pres|VerbForm=Fin
Russian	russian	ADJ	Degree=Pos
Being	be	AUX	VerbForm=Ger
spite	spite	NOUN	Number=Sing
Ft.	Ft.	PROPN	Number=Sing
positive	positive	ADJ	Degree=Pos
organization	organization	NOUN	Number=Sing
Russia	Russia	PROPN	Number=Sing
originally	originally	ADV	_
Brown	Brown	PROPN	Number=Sing
comfortable	comfortable	ADJ	Degree=Pos
implementation	implementation	NOUN	Number=Sing
click	click	VERB	Mood=Imp|VerbForm=Fin
tv	tv	NOUN	Number=Sing
busy	busy	ADJ	Degree=Pos
remain	remain	VERB	VerbForm=Inf
remain	remain	VERB	Mood=Ind|Tense=Pres|VerbForm=Fin
options	option	NOUN	Number=Plur
Apart	apart	ADV	_
restrictions	restriction	NOUN	Number=Plur
red	red	ADJ	Degree=Pos
rude	rude	ADJ	Degree=Pos
respond	respond	VERB	VerbForm=Inf
respond	respond	VERB	Mood=Imp|VerbForm=Fin
who	who	PRON	PronType=Rel
who	who	PRON	PronType=Int
Frank	Frank	PROPN	Number=Sing
fund	fund	NOUN	Number=Sing
words	word	NOUN	Number=Plur
receptionist	receptionist	NOUN	Number=Sing
Space	Space	PROPN	Number=Sing
emails	email	NOUN	Number=Plur
sold	sell	VERB	Tense=Past|VerbForm=Part
needs	need	NOUN	Number=Plur
needs	need	VERB	Mood=Ind|Number=Sing|Person=3|Tense=Pres|VerbForm=Fin
children	child	NOUN	Number=Plur
Zacarias	Zacarias	PROPN	Number=Sing
states	states	PROPN	Number=Sing
states	state	VERB	Mood=Ind|Number=Sing|Person=3|Tense=Pres|VerbForm=Fin
states	state	NOUN	Number=Plur
weekly	weekly	ADJ	Degree=Pos
smooth	smooth	ADJ	Degree=Pos
reasons	reason	NOUN	Number=Plur
fees	fee	NOUN	Number=Plur
participants	participant	NOUN	Number=Plur
approach	approach	NOUN	Number=Sing
Some	some	DET	_
horrible	horrible	ADJ	Degree=Pos
beach	beach	NOUN	Number=Sing
hands	hand	NOUN	Number=Plur
country	country	NOUN	Number=Sing
prepared	prepare	VERB	Tense=Past|VerbForm=Part
end	end	VERB	VerbForm=Inf
end	end	VERB	Mood=Ind|Tense=Pres|VerbForm=Fin
end	end	NOUN	Number=Sing
BBC	BBC	PROPN	Number=Sing
fried	fry	VERB	Tense=Past|VerbForm=Part
invite	invite	VERB	VerbForm=Inf
science	science	NOUN	Number=Sing
.....	.....	PUNCT	_
walking	walk	VERB	VerbForm=Ger
posters	poster	NOUN	Number=Plur
parties	party	NOUN	Number=Plur
values	value	NOUN	Number=Plur
Islands	Islands	PROPN	Number=Plur
partner	partner	NOUN	Number=Sing
Apple	Apple	PROPN	Number=Sing
hear	hear	VERB	VerbForm=Inf
hear	hear	VERB	Mood=Ind|Tense=Pres|VerbForm=Fin
employees	employee	NOUN	Number=Plur
destination	destination	NOUN	Number=Sing
Kerry	Kerry	PROPN	Number=Sing
border	border	NOUN	Number=Sing
responsible	responsible	ADJ	Degree=Pos
navy	navy	NOUN	Number=Sing
minded	minded	ADJ	Degree=Pos
repeatedly	repeatedly	ADV	_
true	true	ADJ	Degree=Pos
TV	tv	NOUN	Number=Sing
happiness	happiness	NOUN	Number=Sing
Product	product	NOUN	Number=Sing
bucks	buck	NOUN	Number=Plur
beef	beef	NOUN	Number=Sing
IT	it	NOUN	Number=Sing
IT	it	PRON	Case=Acc|Gender=Neut|Number=Sing|Person=3|PronType=Prs
IT	it	PRON	Case=Nom|Gender=Neut|Number=Sing|Person=3|PronType=Prs
Absolutely	absolutely	ADV	_
Italy	Italy	PROPN	Number=Sing
criminal	criminal	ADJ	Degree=Pos
20,000	20,000	NUM	NumType=Card
toll	toll	NOUN	Number=Sing
couple	couple	NOUN	Number=Sing
Poor	poor	ADJ	Degree=Pos
certificate	certificate	NOUN	Number=Sing
2003	2003	NUM	NumType=Card
relationships	relationship	NOUN	Number=Plur
handle	handle	VERB	VerbForm=Inf
circles	circle	NOUN	Number=Plur
birthday	birthday	NOUN	Number=Sing
lawyers	lawyer	NOUN	Number=Plur
rescue	rescue	NOUN	Number=Sing
Location	location	NOUN	Number=Sing
important	important	ADJ	Degree=Pos
Help	help	NOUN	Number=Sing
devoted	devoted	ADJ	Degree=Pos
protect	protect	VERB	VerbForm=Inf
8:00	8:00	NUM	NumType=Card
First	first	ADV	_
First	first	ADJ	Degree=Pos|NumType=Ord
First	First	PROPN	Number=Sing
1972	1972	NUM	NumType=Card
photographer	photographer	NOUN	Number=Sing
Conference	Conference	PROPN	Number=Sing
ISI	ISI	PROPN	Number=Sing
keep	keep	VERB	VerbForm=Inf
keep	keep	VERB	Mood=Imp|VerbForm=Fin
keep	keep	VERB	Mood=Ind|Tense=Pres|VerbForm=Fin
commitments	commitment	NOUN	Number=Plur
Tamils	Tamils	PROPN	Number=Plur
School	school	NOUN	Number=Sing
School	School	PROPN	Number=Sing
GOOD	good	ADJ	Degree=Pos
trillion	trillion	NUM	NumType=Card
range	range	NOUN	Number=Sing
threatened	threaten	VERB	Mood=Ind|Tense=Past|VerbForm=Fin
link	link	NOUN	Number=Sing
Islam	Islam	PROPN	Number=Sing
increasingly	increasingly	ADV	_
environment	environment	NOUN	Number=Sing
sleep	sleep	NOUN	Number=Sing
sleep	sleep	VERB	VerbForm=Inf
Kay	Kay	PROPN	Number=Sing
unit	unit	NOUN	Number=Sing
according	accord	VERB	VerbForm=Ger
Moore	Moore	PROPN	Number=Sing
canada	canada	PROPN	Number=Sing
DPR	dpr	NOUN	Number=Sing
advice	advice	NOUN	Number=Sing
transport	transport	NOUN	Number=Sing
$	$	SYM	_
Eric	Eric	PROPN	Number=Sing
jobs	job	NOUN	Number=Plur
UPI	UPI	PROPN	Number=Sing
noticed	notice	VERB	Mood=Ind|Tense=Past|VerbForm=Fin
general	general	NOUN	Number=Sing
general	general	ADJ	Degree=Pos
confident	confident	ADJ	Degree=Pos
category	category	NOUN	Number=Sing
islamists	islamist	NOUN	Number=Plur
mins	min	NOUN	Number=Plur
Taylor	Taylor	PROPN	Number=Sing
breakfast	breakfast	NOUN	Number=Sing
suspected	suspect	VERB	Tense=Past|VerbForm=Part
Last	last	ADJ	Degree=Pos
primarily	primarily	ADV	_
Green	green	ADJ	Degree=Pos
Green	Green	PROPN	Number=Sing
somebody	somebody	PRON	Number=Sing
terrible	terrible	ADJ	Degree=Pos
north	north	ADV	_
north	north	NOUN	Number=Sing
Governor	Governor	PROPN	Number=Sing
program	program	NOUN	Number=Sing
La	La	PROPN	Number=Sing
Winston	Winston	PROPN	Number=Sing
coup	coup	NOUN	Number=Sing
J.	J.	PROPN	Number=Sing
consequences	consequence	NOUN	Number=Plur
Development	Development	PROPN	Number=Sing
Development	development	NOUN	Number=Sing
decision	decision	NOUN	Number=Sing
Ever	ever	ADV	_
normally	normally	ADV	_
carried	carry	VERB	Mood=Ind|Tense=Past|VerbForm=Fin
egg	egg	NOUN	Number=Sing
Hatfill	Hatfill	PROPN	Number=Sing
Chernobyl	Chernobyl	PROPN	Number=Sing
1997	1997	NUM	NumType=Card
together	together	ADV	_
Regarding	regard	VERB	VerbForm=Ger
Mr.	Mr.	PROPN	Number=Sing
guidance	guidance	NOUN	Number=Sing
impact	impact	NOUN	Number=Sing
Anyone	anyone	PRON	Number=Sing
''	''	PUNCT	_
movie	movie	NOUN	Number=Sing
everything	everything	PRON	Number=Sing
player	player	NOUN	Number=Sing
purchase	purchase	NOUN	Number=Sing
purchase	purchase	VERB	VerbForm=Inf
Nations	Nations	PROPN	Number=Sing
learn	learn	VERB	VerbForm=Inf
comments	comment	NOUN	Number=Plur
coupons	coupon	NOUN	Number=Plur
Taiwan	Taiwan	PROPN	Number=Sing
families	family	NOUN	Number=Plur
And	and	CCONJ	_
clinic	clinic	NOUN	Number=Sing
thank	thank	VERB	VerbForm=Inf
thank	thank	VERB	Mood=Ind|Tense=Pres|VerbForm=Fin
okay	okay	ADJ	Degree=Pos
precisely	precisely	ADV	_
ALWAYS	always	ADV	_
wing	wing	NOUN	Number=Sing
larger	larger	ADJ	Degree=Cmp
8:30	8:30	NUM	NumType=Card
victory	victory	NOUN	Number=Sing
regime	regime	NOUN	Number=Sing
neighbor	neighbor	NOUN	Number=Sing
recommendations	recommendation	NOUN	Number=Plur
extend	extend	VERB	VerbForm=Inf
average	average	ADJ	Degree=Pos
surrounded	surround	VERB	Tense=Past|VerbForm=Part|Voice=Pass
tmobile	tmobile	PROPN	Number=Sing
'd	have	AUX	Mood=Ind|Tense=Past|VerbForm=Fin
'd	would	AUX	VerbForm=Fin
herein	herein	ADV	_
signs	sign	NOUN	Number=Plur
conflict	conflict	NOUN	Number=Sing
attacks	attack	NOUN	Number=Plur
worldwide	worldwide	ADV	_
signed	sign	VERB	Mood=Ind|Tense=Past|VerbForm=Fin
signed	sign	VERB	Tense=Past|VerbForm=Part
signed	sign	VERB	Tense=Past|VerbForm=Part|Voice=Pass
lines	line	NOUN	Number=Plur
trial	trial	NOUN	Number=Sing
items	item	NOUN	Number=Plur
Union	union	NOUN	Number=Sing
Union	Union	PROPN	Number=Sing
grateful	grateful	ADJ	Degree=Pos
Lots	lot	NOUN	Number=Plur
Michelle	Michelle	PROPN	Number=Sing
maintenance	maintenance	NOUN	Number=Sing
contracts	contract	NOUN	Number=Plur
fallen	fall	VERB	Tense=Past|VerbForm=Part
west	west	ADV	_
?	?	PUNCT	_
Peoples	people	NOUN	Number=Plur
save	save	VERB	VerbForm=Inf
Nick	Nick	PROPN	Number=Sing
traveling	travel	VERB	VerbForm=Ger
wheels	wheel	NOUN	Number=Plur
successful	successful	ADJ	Degree=Pos
enormous	enormous	ADJ	Degree=Pos
whose	whose	PRON	Poss=Yes|PronType=Int
True	true	ADJ	Degree=Pos
meat	meat	NOUN	Number=Sing
offices	office	NOUN	Number=Plur
1993	1993	NUM	NumType=Card
appreciated	appreciate	VERB	Tense=Past|VerbForm=Part|Voice=Pass
real	real	ADJ	Degree=Pos
spoken	speak	VERB	Tense=Past|VerbForm=Part
Pat	Pat	PROPN	Number=Sing
strongly	strongly	ADV	_
disaster	disaster	NOUN	Number=Sing
wise	wise	ADJ	Degree=Pos
Canadian	Canadian	PROPN	Number=Sing
Canadian	canadian	ADJ	Degree=Pos
glad	glad	ADJ	Degree=Pos
offered	offer	VERB	Mood=Ind|Tense=Past|VerbForm=Fin
offered	offer	VERB	Tense=Past|VerbForm=Part
Janice	Janice	PROPN	Number=Sing
China	China	PROPN	Number=Sing
model	model	NOUN	Number=Sing
hate	hate	VERB	Mood=Ind|Tense=Pres|VerbForm=Fin
police	police	NOUN	Number=Sing
police	police	NOUN	Number=Plur
sales	sale	NOUN	Number=Plur
trip	trip	NOUN	Number=Sing
disease	disease	NOUN	Number=Sing
Brian	Brian	PROPN	Number=Sing
dark	dark	ADJ	Degree=Pos
NOT	not	PART	_
accounting	accounting	NOUN	Number=Sing
figures	figure	NOUN	Number=Plur
poor	poor	ADJ	Degree=Pos
11/10/2000	11/10/2000	NUM	NumType=Card
train	train	NOUN	Number=Sing
train	train	VERB	VerbForm=Inf
Persian	Persian	PROPN	Number=Sing
curves	curve	NOUN	Number=Plur
partners	partner	NOUN	Number=Plur
text	text	NOUN	Number=Sing
care	care	NOUN	Number=Sing
care	care	VERB	VerbForm=Inf
care	care	VERB	Mood=Ind|Tense=Pres|VerbForm=Fin
replace	replace	VERB	VerbForm=Inf
developments	development	NOUN	Number=Plur
initiative	initiative	NOUN	Number=Sing
Thought	think	VERB	Mood=Ind|Tense=Past|VerbForm=Fin
debate	debate	NOUN	Number=Sing
2004	2004	NUM	NumType=Card
slight	slight	ADJ	Degree=Pos
prove	prove	VERB	VerbForm=Inf
70	70	NUM	NumType=Card
CA	CA	PROPN	Number=Sing
.doc	.doc	NOUN	Number=Sing
agreement	agreement	NOUN	Number=Sing
Chicago	Chicago	PROPN	Number=Sing
status	status	NOUN	Number=Sing
Associate	associate	NOUN	Number=Sing
sell	sell	VERB	VerbForm=Inf
sell	sell	VERB	Mood=Ind|Tense=Pres|VerbForm=Fin
Should	should	AUX	VerbForm=Fin
thoughts	thought	NOUN	Number=Plur
concern	concern	NOUN	Number=Sing
further	further	ADV	_
further	further	ADV	Degree=Cmp
further	further	ADJ	Degree=Pos
my	my	PRON	Number=Sing|Person=1|Poss=Yes|PronType=Prs
location	location	NOUN	Number=Sing
coffee	coffee	NOUN	Number=Sing
directions	direction	NOUN	Number=Plur
Put	put	VERB	Mood=Imp|VerbForm=Fin
hundred	hundred	NUM	NumType=Card
Grand	Grand	PROPN	Number=Sing
determine	determine	VERB	VerbForm=Inf
entity	entity	NOUN	Number=Sing
mountains	mountain	NOUN	Number=Plur
they	they	PRON	Case=Nom|Number=Plur|Person=3|PronType=Prs
appears	appear	VERB	Mood=Ind|Number=Sing|Person=3|Tense=Pres|VerbForm=Fin
blood	blood	NOUN	Number=Sing
community	community	NOUN	Number=Sing
L	L	PROPN	Number=Sing
office	office	NOUN	Number=Sing
obvious	obvious	ADJ	Degree=Pos
parking	parking	NOUN	Number=Sing
spelling	spelling	NOUN	Number=Sing
fun	fun	NOUN	Number=Sing
fun	fun	ADJ	Degree=Pos
Beyond	Beyond	PROPN	Number=Sing
dropped	drop	VERB	Mood=Ind|Tense=Past|VerbForm=Fin
tank	tank	NOUN	Number=Sing
friends	friend	NOUN	Number=Plur
description	description	NOUN	Number=Sing
You	you	PRON	Case=Acc|Person=2|PronType=Prs
You	you	PRON	Case=Nom|Person=2|PronType=Prs
had	have	AUX	Mood=Ind|Tense=Past|VerbForm=Fin
had	have	VERB	Tense=Past|VerbForm=Part
had	have	VERB	Mood=Ind|Tense=Past|VerbForm=Fin
4	4	X	_
4	4	NUM	NumType=Card
picture	picture	NOUN	Number=Sing
stated	state	VERB	Tense=Past|VerbForm=Part
stated	state	VERB	Mood=Ind|Tense=Past|VerbForm=Fin
Ireland	Ireland	PROPN	Number=Sing
truly	truly	ADV	_
Schedule	schedule	NOUN	Number=Sing
forgot	forget	VERB	Mood=Ind|Tense=Past|VerbForm=Fin
slowly	slowly	ADV	_
Right	right	ADV	_
exceptional	exceptional	ADJ	Degree=Pos
Where	where	ADV	PronType=Int
forces	force	NOUN	Number=Plur
Eurostar	Eurostar	PROPN	Number=Sing
eventually	eventually	ADV	_
Whether	whether	SCONJ	_
satellite	satellite	NOUN	Number=Sing
become	become	VERB	VerbForm=Inf
become	become	VERB	Tense=Past|VerbForm=Part
Montparnasse	Montparnasse	PROPN	Number=Sing
St	St	PROPN	Number=Sing
seems	seem	VERB	Mood=Ind|Number=Sing|Person=3|Tense=Pres|VerbForm=Fin
15	15	NUM	NumType=Card
worry	worry	VERB	VerbForm=Inf
worry	worry	VERB	Mood=Imp|VerbForm=Fin
expression	expression	NOUN	Number=Sing
???	???	PUNCT	_
although	although	SCONJ	_
Auto	Auto	PROPN	Number=Sing
industry	industry	NOUN	Number=Sing
Fast	fast	ADJ	Degree=Pos
conferences	conference	NOUN	Number=Plur
solution	solution	NOUN	Number=Sing
CEO	ceo	NOUN	Number=Sing
Attached	attach	VERB	Tense=Past|VerbForm=Part
Attached	attach	VERB	Tense=Past|VerbForm=Part|Voice=Pass
initiate	initiate	VERB	VerbForm=Inf
George	George	PROPN	Number=Sing
massive	massive	ADJ	Degree=Pos
whenever	whenever	ADV	PronType=Int
why	why	ADV	PronType=Rel
why	why	ADV	PronType=Int
hour	hour	NOUN	Number=Sing
dress	dress	NOUN	Number=Sing
shoulder	shoulder	NOUN	Number=Sing
!!!!!!	!!!!!!	PUNCT	_
Musharraf	Musharraf	PROPN	Number=Sing
quality	quality	NOUN	Number=Sing
quality	quality	ADJ	Degree=Pos
knew	know	VERB	Mood=Ind|Tense=Past|VerbForm=Fin
which	which	PRON	PronType=Rel
which	which	DET	PronType=Int
which	which	PRON	PronType=Int
publicly	publicly	ADV	_
creative	creative	ADJ	Degree=Pos
talented	talented	ADJ	Degree=Pos
planning	planning	NOUN	Number=Sing
planning	plan	VERB	Tense=Pres|VerbForm=Part
planning	plan	VERB	VerbForm=Ger
Seoul	Seoul	PROPN	Number=Sing
eat	eat	VERB	VerbForm=Inf
eat	eat	VERB	Mood=Ind|Tense=Pres|VerbForm=Fin
button	button	NOUN	Number=Sing
files	file	NOUN	Number=Plur
water	water	NOUN	Number=Sing
aggressive	aggressive	ADJ	Degree=Pos
daughter	daughter	NOUN	Number=Sing
inventory	inventory	NOUN	Number=Sing
Experience	experience	NOUN	Number=Sing
follow	follow	VERB	VerbForm=Inf
Parts	part	NOUN	Number=Plur
first	first	ADV	_
first	first	ADJ	Degree=Pos|NumType=Ord
me	I	PRON	Case=Acc|Number=Sing|Person=1|PronType=Prs
repair	repair	NOUN	Number=Sing
militant	militant	ADJ	Degree=Pos
deliver	deliver	VERB	VerbForm=Inf
cabin	cabin	NOUN	Number=Sing
building	building	NOUN	Number=Sing
An	a	DET	Definite=Ind|PronType=Art
ta	to	PART	Abbr=Yes
Mississauga	Mississauga	PROPN	Number=Sing
revisions	revision	NOUN	Number=Plur
====================================================	====================================================	SYM	_
quiet	quiet	ADJ	Degree=Pos
store	store	NOUN	Number=Sing
steps	step	NOUN	Number=Plur
suspicious	suspicious	ADJ	Degree=Pos
decent	decent	ADJ	Degree=Pos
Khan	Khan	PROPN	Number=Sing
Lebanese	lebanese	ADJ	Degree=Pos
Office	office	NOUN	Number=Sing
Office	Office	PROPN	Number=Sing
agree	agree	VERB	VerbForm=Inf
agree	agree	VERB	Mood=Ind|Tense=Pres|VerbForm=Fin
Going	go	VERB	VerbForm=Ger
Federal	Federal	PROPN	Number=Sing
Federal	federal	ADJ	Degree=Pos
parakeets	parakeet	NOUN	Number=Plur
Perhaps	perhaps	ADV	_
Sent	send	VERB	Tense=Past|VerbForm=Part
fundamental	fundamental	ADJ	Degree=Pos
models	model	NOUN	Number=Plur
meals	meal	NOUN	Number=Plur
rare	rare	ADJ	Degree=Pos
helped	help	VERB	Mood=Ind|Tense=Past|VerbForm=Fin
drove	drive	VERB	Mood=Ind|Tense=Past|VerbForm=Fin
control	control	NOUN	Number=Sing
control	control	VERB	VerbForm=Inf
toys	toy	NOUN	Number=Plur
stores	store	NOUN	Number=Plur
papers	papers	NOUN	Number=Plur
college	college	NOUN	Number=Sing
mechanism	mechanism	NOUN	Number=Sing
trouble	trouble	NOUN	Number=Sing
Elbertson	Elbertson	PROPN	Number=Sing
recording	recording	NOUN	Number=Sing
300	300	NUM	NumType=Card
carrying	carry	VERB	VerbForm=Ger
drinks	drink	NOUN	Number=Plur
cruises	cruise	NOUN	Number=Plur
enter	enter	VERB	VerbForm=Inf
Rude	rude	ADJ	Degree=Pos
relations	relation	NOUN	Number=Plur
9/11	9/11	NUM	NumType=Card
pockets	pocket	NOUN	Number=Plur
enemy	enemy	NOUN	Number=Sing
answer	answer	NOUN	Number=Sing
answer	answer	VERB	VerbForm=Inf
Analyst	analyst	NOUN	Number=Sing
studies	study	NOUN	Number=Plur
overwhelming	overwhelming	ADJ	Degree=Pos
knowing	know	VERB	VerbForm=Ger
suggesting	suggest	VERB	VerbForm=Ger
EB	EB	PROPN	Number=Sing
â€	"	PUNCT	_
Jim	Jim	PROPN	Number=Sing
summer	summer	NOUN	Number=Sing
cooked	cook	VERB	Tense=Past|VerbForm=Part
barn	barn	NOUN	Number=Sing
figured	figure	VERB	Mood=Ind|Tense=Past|VerbForm=Fin
halal	halal	ADJ	Degree=Pos
menu	menu	NOUN	Number=Sing
Republic	Republic	PROPN	Number=Sing
Horrible	horrible	ADJ	Degree=Pos
763736	763736	NUM	NumType=Card
Hopefully	hopefully	ADV	_
gave	give	VERB	Mood=Ind|Tense=Past|VerbForm=Fin
lucky	lucky	ADJ	Degree=Pos
corner	corner	NOUN	Number=Sing
upon	upon	ADP	_
upon	upon	SCONJ	_
Terry	Terry	PROPN	Number=Sing
radical	radical	ADJ	Degree=Pos
snack	snack	NOUN	Number=Sing
unique	unique	ADJ	Degree=Pos
investors	investor	NOUN	Number=Plur
amount	amount	NOUN	Number=Sing
Ironically	ironically	ADV	_
written	write	VERB	Tense=Past|VerbForm=Part|Voice=Pass
written	write	VERB	Tense=Past|VerbForm=Part
receipt	receipt	NOUN	Number=Sing
Stan	Stan	PROPN	Number=Sing
Steven	Steven	PROPN	Number=Sing
One	one	NUM	NumType=Card
At	at	ADV	_
At	at	ADP	_
joke	joke	NOUN	Number=Sing
N	N	PROPN	Number=Sing
danger	danger	NOUN	Number=Sing
Anyway	anyway	INTJ	_
Anyway	anyway	ADV	_
Inc.	Inc.	PROPN	Number=Sing
point	point	NOUN	Number=Sing
rear	rear	ADJ	Degree=Pos
December	December	PROPN	Number=Sing
id	id	NOUN	Number=Sing
morality	morality	NOUN	Number=Sing
leg	leg	NOUN	Number=Sing
alike	alike	ADJ	Degree=Pos
Santa	Santa	PROPN	Number=Sing
religious	religious	ADJ	Degree=Pos
implications	implication	NOUN	Number=Plur
AT	at	ADP	_
Government	government	NOUN	Number=Sing
prefer	prefer	VERB	Mood=Ind|Tense=Pres|VerbForm=Fin
prefer	prefer	VERB	VerbForm=Inf
enjoyed	enjoy	VERB	Mood=Ind|Tense=Past|VerbForm=Fin
Korea	Korea	PROPN	Number=Sing
correlation	correlation	NOUN	Number=Sing
Katrina	Katrina	PROPN	Number=Sing
live	live	VERB	Mood=Ind|Tense=Pres|VerbForm=Fin
live	live	VERB	VerbForm=Inf
live	live	ADJ	Degree=Pos
cartoons	cartoon	NOUN	Number=Plur
walked	walk	VERB	Mood=Ind|Tense=Past|VerbForm=Fin
treated	treat	VERB	Tense=Past|VerbForm=Part|Voice=Pass
treated	treat	VERB	Tense=Past|VerbForm=Part
treated	treat	VERB	Mood=Ind|Tense=Past|VerbForm=Fin
obtain	obtain	VERB	VerbForm=Inf
taking	take	VERB	VerbForm=Ger
taking	take	VERB	Tense=Pres|VerbForm=Part
mentioned	mention	VERB	Mood=Ind|Tense=Past|VerbForm=Fin
administration	administration	NOUN	Number=Sing
testimony	testimony	NOUN	Number=Sing
ones	one	NOUN	Number=Plur
price	price	NOUN	Number=Sing
progress	progress	NOUN	Number=Sing
_	_	SYM	_
cabinet	cabinet	NOUN	Number=Sing
Company	company	NOUN	Number=Sing
exploration	exploration	NOUN	Number=Sing
NASA	NASA	PROPN	Number=Sing
Works	Works	PROPN	Number=Plur
block	block	NOUN	Number=Sing
investigation	investigation	NOUN	Number=Sing
fundamentalists	fundamentalist	NOUN	Number=Plur
cheapest	cheapest	ADJ	Degree=Sup
Islamist	Islamist	PROPN	Number=Sing
discussion	discussion	NOUN	Number=Sing
Ali	Ali	PROPN	Number=Sing
sides	side	NOUN	Number=Plur
typical	typical	ADJ	Degree=Pos
week	week	NOUN	Number=Sing
gone	gone	ADJ	Degree=Pos
gone	go	VERB	Tense=Past|VerbForm=Part
right	right	NOUN	Number=Sing
right	right	ADJ	Degree=Pos
right	right	ADV	_
human	human	ADJ	Degree=Pos
Gulf	Gulf	PROPN	Number=Sing
Gulf	gulf	NOUN	Number=Sing
Job	job	NOUN	Number=Sing
remote	remote	ADJ	Degree=Pos
cares	care	VERB	Mood=Ind|Number=Sing|Person=3|Tense=Pres|VerbForm=Fin
evening	evening	NOUN	Number=Sing
yes	yes	INTJ	_
most	most	ADJ	Degree=Sup
most	most	ADV	_
french	french	ADJ	Degree=Pos
compressor	compressor	NOUN	Number=Sing
starting	start	VERB	VerbForm=Ger
starting	starting	NOUN	Number=Sing
speech	speech	NOUN	Number=Sing
remaining	remain	VERB	VerbForm=Ger
Guinea	guinea	NOUN	Number=Sing
modem	modem	NOUN	Number=Sing
potential	potential	ADJ	Degree=Pos
large	large	ADJ	Degree=Pos
unknown	unknown	ADJ	Degree=Pos
gives	give	VERB	Mood=Ind|Number=Sing|Person=3|Tense=Pres|VerbForm=Fin
ENA	ENA	PROPN	Number=Sing
bodies	body	NOUN	Number=Plur
respect	respect	NOUN	Number=Sing
projects	project	NOUN	Number=Plur
Orders	order	NOUN	Number=Plur
review	review	NOUN	Number=Sing
review	review	VERB	VerbForm=Inf
review	review	VERB	Mood=Imp|VerbForm=Fin
Selah	Selah	PROPN	Number=Sing
views	view	NOUN	Number=Plur
port	port	NOUN	Number=Sing
schools	school	NOUN	Number=Plur
adds	add	VERB	Mood=Ind|Number=Sing|Person=3|Tense=Pres|VerbForm=Fin
telephone	telephone	NOUN	Number=Sing
importantly	importantly	ADV	_
.!	.!	PUNCT	_
Doug	Doug	PROPN	Number=Sing
tasted	taste	VERB	Mood=Ind|Tense=Past|VerbForm=Fin
MY	my	PRON	Number=Sing|Person=1|Poss=Yes|PronType=Prs
operate	operate	VERB	VerbForm=Inf
vehicle	vehicle	NOUN	Number=Sing
nature	nature	NOUN	Number=Sing
Dear	dear	ADJ	Degree=Pos
Ray	Ray	PROPN	Number=Sing
overall	overall	ADJ	Degree=Pos
overall	overall	ADV	_
centre	centre	NOUN	Number=Sing
fixing	fix	VERB	VerbForm=Ger
Room	room	NOUN	Number=Sing
South	South	PROPN	Number=Sing
color	color	NOUN	Number=Sing
advanced	advanced	ADJ	Degree=Pos
High	high	ADJ	Degree=Pos
High	High	PROPN	Number=Sing
warfare	warfare	NOUN	Number=Sing
part	part	NOUN	Number=Sing
part	part	ADJ	Degree=Pos
Love	love	VERB	Mood=Ind|Tense=Pres|VerbForm=Fin
wanted	want	VERB	Mood=Ind|Tense=Past|VerbForm=Fin
additional	additional	ADJ	Degree=Pos
forms	form	NOUN	Number=Plur
T.V.	t.v.	NOUN	Number=Sing
House	House	PROPN	Number=Sing
Continue	continue	VERB	Mood=Imp|VerbForm=Fin
religion	religion	NOUN	Number=Sing
lol	lol	INTJ	_
trade	trade	NOUN	Number=Sing
trade	trade	VERB	VerbForm=Inf
While	while	SCONJ	_
ekrapels@esaibos.com	ekrapels@esaibos.com	X	_
Dubai	Dubai	PROPN	Number=Sing
measure	measure	NOUN	Number=Sing
videos	video	NOUN	Number=Plur
Asia	Asia	PROPN	Number=Sing
points	point	NOUN	Number=Plur
tasty	tasty	ADJ	Degree=Pos
arrest	arrest	NOUN	Number=Sing
Service	service	NOUN	Number=Sing
Service	Service	PROPN	Number=Sing
sweet	sweet	ADJ	Degree=Pos
-	-	SYM	_
-	-	PUNCT	_
-	-	X	_
White	White	PROPN	Number=Sing
names	name	NOUN	Number=Plur
pipeline	pipeline	NOUN	Number=Sing
Phone	phone	NOUN	Number=Sing
challenging	challenging	ADJ	Degree=Pos
Aires	Aires	PROPN	Number=Sing
hall	hall	NOUN	Number=Sing
3	3	X	_
3	3	NUM	NumType=Card
Price	price	NOUN	Number=Sing
tables	table	NOUN	Number=Plur
Wei	Wei	PROPN	Number=Sing
Titman	Titman	PROPN	Number=Sing
Travis	Travis	PROPN	Number=Sing
construction	construction	NOUN	Number=Sing
helps	help	VERB	Mood=Ind|Number=Sing|Person=3|Tense=Pres|VerbForm=Fin
similar	similar	ADJ	Degree=Pos
UT	UT	PROPN	Number=Sing
Hodge	Hodge	PROPN	Number=Sing
turned	turn	VERB	Mood=Ind|Tense=Past|VerbForm=Fin
Ok	ok	INTJ	_
difficulty	difficulty	NOUN	Number=Sing
snake	snake	NOUN	Number=Sing
met	meet	VERB	Mood=Ind|Tense=Past|VerbForm=Fin
met	meet	VERB	Tense=Past|VerbForm=Part
Force	Force	PROPN	Number=Sing
early	early	ADJ	Degree=Pos
early	early	ADV	Degree=Pos
despite	despite	ADP	_
there	there	ADV	PronType=Dem
there	there	PRON	_
During	during	ADP	_
lighter	lighter	ADJ	Degree=Cmp
24	24	NUM	NumType=Card
period	period	NOUN	Number=Sing
SO	so	ADV	_
wine	wine	NOUN	Number=Sing
Compaq	Compaq	PROPN	Number=Sing
Each	each	DET	_
professional	professional	ADJ	Degree=Pos
Air	Air	PROPN	Number=Sing
wealth	wealth	NOUN	Number=Sing
F	F	PROPN	Number=Sing
distribution	distribution	NOUN	Number=Sing
schedule	schedule	NOUN	Number=Sing
delivered	deliver	VERB	Tense=Past|VerbForm=Part|Voice=Pass
delivered	deliver	VERB	Tense=Past|VerbForm=Part
delivered	deliver	VERB	Mood=Ind|Tense=Past|VerbForm=Fin
cell	cell	NOUN	Number=Sing
Joe	Joe	PROPN	Number=Sing
term	term	NOUN	Number=Sing
GOD	GOD	PROPN	Number=Sing
approve	approve	VERB	Mood=Imp|VerbForm=Fin
kept	keep	VERB	Tense=Past|VerbForm=Part
kept	keep	VERB	Mood=Ind|Tense=Past|VerbForm=Fin
kept	keep	VERB	Tense=Past|VerbForm=Part|Voice=Pass
tile	tile	NOUN	Number=Sing
250	250	NUM	NumType=Card
eager	eager	ADJ	Degree=Pos
common	common	ADJ	Degree=Pos
clean	clean	VERB	VerbForm=Inf
clean	clean	ADJ	Degree=Pos
game	game	NOUN	Number=Sing
Red	Red	PROPN	Number=Sing
recipient	recipient	NOUN	Number=Sing
missed	miss	VERB	Mood=Ind|Tense=Past|VerbForm=Fin
wrong	wrong	ADJ	Degree=Pos
wrong	wrong	ADV	_
thru	through	ADP	Abbr=Yes
NATO	NATO	PROPN	Number=Sing
hospitals	hospital	NOUN	Number=Plur
multiple	multiple	ADJ	Degree=Pos
Dunn	Dunn	PROPN	Number=Sing
2	2	NUM	NumType=Card
2	2	X	_
several	several	ADJ	Degree=Pos
everybody	everybody	PRON	Number=Sing
implement	implement	VERB	VerbForm=Inf
exists	exist	VERB	Mood=Ind|Number=Sing|Person=3|Tense=Pres|VerbForm=Fin
Silkie	silkie	NOUN	Number=Sing
housing	housing	NOUN	Number=Sing
ingredients	ingredient	NOUN	Number=Plur
Jane	Jane	PROPN	Number=Sing
behind	behind	ADP	_
movements	movement	NOUN	Number=Plur
palace	palace	NOUN	Number=Sing
have	have	AUX	Mood=Ind|Tense=Pres|VerbForm=Fin
have	have	VERB	Mood=Ind|Tense=Pres|VerbForm=Fin
have	have	VERB	VerbForm=Inf
have	have	AUX	VerbForm=Inf
have	have	VERB	Mood=Imp|VerbForm=Fin
Edison	Edison	PROPN	Number=Sing
fresh	fresh	ADJ	Degree=Pos
working	work	VERB	Tense=Pres|VerbForm=Part
working	work	VERB	VerbForm=Ger
working	working	NOUN	Number=Sing
Jean	Jean	PROPN	Number=Sing
waited	wait	VERB	Mood=Ind|Tense=Past|VerbForm=Fin
foot	foot	NOUN	Number=Sing
Mayko	Mayko	PROPN	Number=Sing
Street	Street	PROPN	Number=Sing
users	user	NOUN	Number=Plur
WOW	wow	INTJ	_
targets	target	NOUN	Number=Plur
spending	spending	NOUN	Number=Sing
spending	spend	VERB	VerbForm=Ger
report	report	NOUN	Number=Sing
equal	equal	ADJ	Degree=Pos
put	put	VERB	Mood=Ind|Tense=Pres|VerbForm=Fin
put	put	VERB	VerbForm=Inf
put	put	VERB	Mood=Ind|Tense=Past|VerbForm=Fin
put	put	VERB	Tense=Past|VerbForm=Part|Voice=Pass
put	put	VERB	Tense=Past|VerbForm=Part
put	put	VERB	Mood=Imp|VerbForm=Fin
been	be	VERB	Tense=Past|VerbForm=Part
been	be	AUX	Tense=Past|VerbForm=Part
hair	hair	NOUN	Number=Sing
notice	notice	VERB	VerbForm=Inf
notice	notice	NOUN	Number=Sing
attend	attend	VERB	VerbForm=Inf
frequently	frequently	ADV	_
Color	Color	PROPN	Number=Sing
locally	locally	ADV	_
counterparty	counterparty	NOUN	Number=Sing
reference	reference	VERB	VerbForm=Inf
reference	reference	NOUN	Number=Sing
Let	let	VERB	Mood=Imp|VerbForm=Fin
filled	fill	VERB	Tense=Past|VerbForm=Part
seriously	seriously	ADV	_
will	will	NOUN	Number=Sing
will	will	AUX	VerbForm=Fin
Leon	Leon	PROPN	Number=Sing
Department	Department	PROPN	Number=Sing
Pakistan	Pakistan	PROPN	Number=Sing
Warwick	Warwick	PROPN	Number=Sing
kitchen	kitchen	NOUN	Number=Sing
parakeet	parakeet	NOUN	Number=Sing
launched	launch	VERB	Mood=Ind|Tense=Past|VerbForm=Fin
approved	approve	VERB	Tense=Past|VerbForm=Part
approved	approve	VERB	Mood=Ind|Tense=Past|VerbForm=Fin
approved	approve	VERB	Tense=Past|VerbForm=Part|Voice=Pass
Christians	Christians	PROPN	Number=Plur
seem	seem	VERB	VerbForm=Inf
seem	seem	VERB	Mood=Ind|Tense=Pres|VerbForm=Fin
03/15/2001	03/15/2001	NUM	NumType=Card
2009	2009	NUM	NumType=Card
farrier	farrier	NOUN	Number=Sing
AM	am	NOUN	Number=Sing
guide	guide	NOUN	Number=Sing
analysis	analysis	NOUN	Number=Sing
supplies	supplies	NOUN	Number=Plur
dresses	dress	NOUN	Number=Plur
acts	act	NOUN	Number=Plur
shape	shape	NOUN	Number=Sing
troops	troops	NOUN	Number=Plur
Pretty	pretty	ADV	_
Are	be	AUX	Mood=Ind|Tense=Pres|VerbForm=Fin
Are	be	VERB	Mood=Ind|Tense=Pres|VerbForm=Fin
burger	burger	NOUN	Number=Sing
Frisco	Frisco	PROPN	Number=Sing
Palestinians	Palestinians	PROPN	Number=Plur
Yahoo!	Yahoo!	PROPN	Number=Sing
total	total	NOUN	Number=Sing
total	total	ADJ	Degree=Pos
Mexico	Mexico	PROPN	Number=Sing
server	server	NOUN	Number=Sing
property	property	NOUN	Number=Sing
military	military	ADJ	Degree=Pos
military	military	NOUN	Number=Sing
reaction	reaction	NOUN	Number=Sing
closely	closely	ADV	_
1987	1987	NUM	NumType=Card
persons	person	NOUN	Number=Plur
Republican	Republican	PROPN	Number=Sing
Republican	republican	ADJ	Degree=Pos
encourage	encourage	VERB	VerbForm=Inf
FERC	FERC	PROPN	Number=Sing
actions	action	NOUN	Number=Plur
considerable	considerable	ADJ	Degree=Pos
cent	cent	NOUN	Number=Sing
promise	promise	NOUN	Number=Sing
promise	promise	VERB	Mood=Ind|Tense=Pres|VerbForm=Fin
liquidation	liquidation	NOUN	Number=Sing
windows	window	NOUN	Number=Plur
EBS	EBS	PROPN	Number=Sing
given	give	VERB	Tense=Past|VerbForm=Part
given	give	VERB	Tense=Past|VerbForm=Part|Voice=Pass
spirit	spirit	NOUN	Number=Sing
Coach	coach	NOUN	Number=Sing
movement	movement	NOUN	Number=Sing
into	into	SCONJ	_
into	into	ADP	_
messages	message	NOUN	Number=Plur
always	always	ADV	_
fee	fee	NOUN	Number=Sing
Systems	Systems	PROPN	Number=Plur
members	member	NOUN	Number=Plur
did	do	AUX	Mood=Ind|Tense=Past|VerbForm=Fin
did	do	VERB	Mood=Ind|Tense=Past|VerbForm=Fin
August	August	PROPN	Number=Sing
subject	subject	NOUN	Number=Sing
subject	subject	ADJ	Degree=Pos
previously	previously	ADV	_
strategy	strategy	NOUN	Number=Sing
health	health	NOUN	Number=Sing
GCP	gcp	NOUN	Number=Sing
nothing	nothing	PRON	Number=Sing
On	on	ADP	_
General	General	PROPN	Number=Sing
65	65	NUM	NumType=Card
material	material	NOUN	Number=Sing
No	no	DET	_
No	no	ADV	_
No	no	INTJ	_
phone	phone	NOUN	Number=Sing
updates	update	NOUN	Number=Plur
bread	bread	NOUN	Number=Sing
Committee	committee	NOUN	Number=Sing
Committee	Committee	PROPN	Number=Sing
s	s	X	_
s	be	AUX	Mood=Ind|Number=Sing|Person=3|Tense=Pres|VerbForm=Fin
s	s	PRON	Case=Acc|Number=Plur|Person=1|PronType=Prs
s	be	VERB	Mood=Ind|Number=Sing|Person=3|Tense=Pres|VerbForm=Fin
s	's	PART	_
treatment	treatment	NOUN	Number=Sing
tons	ton	NOUN	Number=Plur
Master	master	NOUN	Number=Sing
Siddiqui	Siddiqui	PROPN	Number=Sing
parts	part	NOUN	Number=Plur
WHEN	when	ADV	PronType=Int
select	select	VERB	Mood=Imp|VerbForm=Fin
leaders	leader	NOUN	Number=Plur
Mozilla	Mozilla	PROPN	Number=Sing
January	January	PROPN	Number=Sing
cruise	cruise	NOUN	Number=Sing
onto	onto	ADP	_
quick	quick	ADV	_
quick	quick	ADJ	Degree=Pos
OBSF	obsf	NOUN	Number=Sing
value	value	NOUN	Number=Sing
kids	kid	NOUN	Number=Plur
standards	standard	NOUN	Number=Plur
April	April	PROPN	Number=Sing
150	150	NUM	NumType=Card
answering	answer	VERB	VerbForm=Ger
honesty	honesty	NOUN	Number=Sing
night	night	NOUN	Number=Sing
heads	head	NOUN	Number=Plur
â€“	-	PUNCT	_
inch	inch	NOUN	Number=Sing
Corp.	Corp.	PROPN	Number=Sing
enjoyable	enjoyable	ADJ	Degree=Pos
money	money	NOUN	Number=Sing
enrongss.xls	enrongss.xls	NOUN	Number=Sing
law	law	NOUN	Number=Sing
Act	Act	PROPN	Number=Sing
Can	can	AUX	VerbForm=Fin
expert	expert	NOUN	Number=Sing
coverage	coverage	NOUN	Number=Sing
commit	commit	VERB	VerbForm=Inf
suit	suit	NOUN	Number=Sing
City	City	PROPN	Number=Sing
War	War	PROPN	Number=Sing
settlement	settlement	NOUN	Number=Sing
carbon	carbon	NOUN	Number=Sing
Transwestern	Transwestern	PROPN	Number=Sing
finished	finished	ADJ	Degree=Pos
finished	finish	VERB	Tense=Past|VerbForm=Part
fill	fill	VERB	VerbForm=Inf
trading	trading	NOUN	Number=Sing
purpose	purpose	NOUN	Number=Sing
it's	it's	PRON	_
5,000	5,000	NUM	NumType=Card
wide	wide	ADJ	Degree=Pos
Feel	feel	VERB	Mood=Imp|VerbForm=Fin
push	push	VERB	VerbForm=Inf
nine	nine	NUM	NumType=Card
S.	S.	PROPN	Number=Sing
fat	fat	ADJ	Degree=Pos
Titanic	Titanic	PROPN	Number=Sing
Susan	Susan	PROPN	Number=Sing
Japan	Japan	PROPN	Number=Sing
Who	who	PRON	PronType=Int
Unfortunately	unfortunately	ADV	_
...	...	PUNCT	_
...	...	SYM	_
sump	sump	NOUN	Number=Sing
judge	judge	NOUN	Number=Sing
afraid	afraid	ADJ	Degree=Pos
1	1	NUM	NumType=Card
1	1	X	_
interviews	interview	NOUN	Number=Plur
threat	threat	NOUN	Number=Sing
Atlanta	Atlanta	PROPN	Number=Sing
passing	pass	VERB	VerbForm=Ger
Muslims	Muslims	PROPN	Number=Plur
Sanders	Sanders	PROPN	Number=Sing
lovely	lovely	ADJ	Degree=Pos
method	method	NOUN	Number=Sing
depending	depend	VERB	VerbForm=Ger
workers	worker	NOUN	Number=Plur
sight	sight	NOUN	Number=Sing
tickets	ticket	NOUN	Number=Plur
simple	simple	ADJ	Degree=Pos
80	80	NUM	NumType=Card
Many	many	ADJ	Degree=Pos
blocks	block	NOUN	Number=Plur
Jason	Jason	PROPN	Number=Sing
MEH-risk	meh-risk	X	_
chef	chef	NOUN	Number=Sing
dead	dead	ADJ	Degree=Pos
Get	get	VERB	Mood=Imp|VerbForm=Fin
stock	stock	NOUN	Number=Sing
Home	home	NOUN	Number=Sing
Home	Home	PROPN	Number=Sing
decor	decor	NOUN	Number=Sing
alone	alone	ADJ	Degree=Pos
alone	alone	ADV	_
200,000	200,000	NUM	NumType=Card
Mark	Mark	PROPN	Number=Sing
WTC	WTC	PROPN	Number=Sing
Power	power	NOUN	Number=Sing
make	make	VERB	Mood=Ind|Tense=Pres|VerbForm=Fin
make	make	VERB	Mood=Imp|VerbForm=Fin
make	make	VERB	VerbForm=Inf
by	by	SCONJ	_
by	by	ADP	_
by	by	ADV	_
special	special	ADJ	Degree=Pos
USS	USS	PROPN	Number=Sing
Worth	Worth	PROPN	Number=Sing
indicated	indicate	VERB	Mood=Ind|Tense=Past|VerbForm=Fin
break	break	VERB	VerbForm=Inf
break	break	NOUN	Number=Sing
island	island	NOUN	Number=Sing
does	do	AUX	Mood=Ind|Number=Sing|Person=3|Tense=Pres|VerbForm=Fin
does	do	VERB	Mood=Ind|Number=Sing|Person=3|Tense=Pres|VerbForm=Fin
forwarded	forward	VERB	Tense=Past|VerbForm=Part|Voice=Pass
provide	provide	VERB	Mood=Ind|Tense=Pres|VerbForm=Fin
provide	provide	VERB	VerbForm=Inf
even	even	ADV	_
revision	revision	NOUN	Number=Sing
essential	essential	ADJ	Degree=Pos
Hino	Hino	PROPN	Number=Sing
27	27	NUM	NumType=Card
modern	modern	ADJ	Degree=Pos
beautiful	beautiful	ADJ	Degree=Pos
became	become	VERB	Mood=Ind|Tense=Past|VerbForm=Fin
#	#	NOUN	Number=Sing
serious	serious	ADJ	Degree=Pos
Davis	Davis	PROPN	Number=Sing
bland	bland	ADJ	Degree=Pos
gas	gas	NOUN	Number=Sing
Hidden	Hidden	PROPN	Number=Sing
head	head	NOUN	Number=Sing
Park	Park	PROPN	Number=Sing
dog	dog	NOUN	Number=Sing
church	church	NOUN	Number=Sing
young	young	ADJ	Degree=Pos
invasion	invasion	NOUN	Number=Sing
couch	couch	NOUN	Number=Sing
Richmond	Richmond	PROPN	Number=Sing
mailings	mailing	NOUN	Number=Plur
power	power	NOUN	Number=Sing
cells	cell	NOUN	Number=Plur
STEP	step	NOUN	Number=Sing
Sam	Sam	PROPN	Number=Sing
Essex	Essex	PROPN	Number=Sing
extent	extent	NOUN	Number=Sing
opening	opening	NOUN	Number=Sing
opening	open	VERB	VerbForm=Ger
James	James	PROPN	Number=Sing
died	die	VERB	Mood=Ind|Tense=Past|VerbForm=Fin
official	official	ADJ	Degree=Pos
official	official	NOUN	Number=Sing
integrity	integrity	NOUN	Number=Sing
cabins	cabin	NOUN	Number=Plur
dirt	dirt	NOUN	Number=Sing
n't	not	PART	_
violent	violent	ADJ	Degree=Pos
hand	hand	NOUN	Number=Sing
Hamster	hamster	NOUN	Number=Sing
correctly	correctly	ADV	_
immediate	immediate	ADJ	Degree=Pos
Philip	Philip	PROPN	Number=Sing
gun	gun	NOUN	Number=Sing
particularly	particularly	ADV	_
M	m	NOUN	Number=Sing
M	m	NUM	NumType=Card
message	message	NOUN	Number=Sing
married	marry	VERB	Tense=Past|VerbForm=Part|Voice=Pass
authority	authority	NOUN	Number=Sing
losing	lose	VERB	VerbForm=Ger
Alberta	alberta	X	_
seats	seat	NOUN	Number=Plur
United	United	PROPN	Number=Sing
struggle	struggle	NOUN	Number=Sing
self	self	NOUN	Number=Sing
2000	2000	NUM	NumType=Card
ultimately	ultimately	ADV	_
,	,	PUNCT	_
extraordinary	extraordinary	ADJ	Degree=Pos
released	release	VERB	Tense=Past|VerbForm=Part|Voice=Pass
released	release	VERB	Mood=Ind|Tense=Past|VerbForm=Fin
released	release	VERB	Tense=Past|VerbForm=Part
Lebanon	Lebanon	PROPN	Number=Sing
Although	although	SCONJ	_
WITH	with	ADP	_
door	door	NOUN	Number=Sing
Kumaratunga	Kumaratunga	PROPN	Number=Sing
Risk	Risk	PROPN	Number=Sing
Risk	risk	NOUN	Number=Sing
keeping	keep	VERB	Tense=Pres|VerbForm=Part
keeping	keep	VERB	VerbForm=Ger
bird	bird	NOUN	Number=Sing
HAVE	have	VERB	Mood=Ind|Tense=Pres|VerbForm=Fin
relationship	relationship	NOUN	Number=Sing
continues	continue	VERB	Mood=Ind|Number=Sing|Person=3|Tense=Pres|VerbForm=Fin
coast	coast	NOUN	Number=Sing
ran	run	VERB	Mood=Ind|Tense=Past|VerbForm=Fin
EOL	EOL	PROPN	Number=Sing
EOL	eol	NOUN	Number=Sing
violence	violence	NOUN	Number=Sing
or	or	CCONJ	_
signoff	signoff	NOUN	Number=Sing
incident	incident	NOUN	Number=Sing
explore	explore	VERB	VerbForm=Inf
divisions	division	NOUN	Number=Plur
damage	damage	NOUN	Number=Sing
Wars	Wars	PROPN	Number=Plur
as	as	ADP	_
as	as	ADV	_
as	as	SCONJ	_
Mary	Mary	PROPN	Number=Sing
space	space	NOUN	Number=Sing
Bill	Bill	PROPN	Number=Sing
incorporated	incorporate	VERB	Tense=Past|VerbForm=Part
enron	enron	PROPN	Number=Sing
filing	filing	NOUN	Number=Sing
Sudan	Sudan	PROPN	Number=Sing
spend	spend	VERB	VerbForm=Inf
wheel	wheel	NOUN	Number=Sing
Counterparty	counterparty	NOUN	Number=Sing
clause	clause	NOUN	Number=Sing
eggs	egg	NOUN	Number=Plur
plan	plan	VERB	Mood=Ind|Tense=Pres|VerbForm=Fin
plan	plan	VERB	VerbForm=Inf
plan	plan	NOUN	Number=Sing
desk	desk	NOUN	Number=Sing
01-Feb-02	01-feb-02	NOUN	Number=Sing
former	former	ADJ	Degree=Pos
affordable	affordable	ADJ	Degree=Pos
Kevin	Kevin	PROPN	Number=Sing
down	down	ADP	_
down	down	ADV	_
back	back	ADV	_
back	back	ADJ	Degree=Pos
back	back	ADP	_
back	back	NOUN	Number=Sing
bombing	bombing	NOUN	Number=Sing
therapist	therapist	NOUN	Number=Sing
rolls	roll	NOUN	Number=Plur
gem	gem	NOUN	Number=Sing
Coordinator	coordinator	NOUN	Number=Sing
Chinese	chinese	ADJ	Degree=Pos
Was	be	AUX	Mood=Ind|Number=Sing|Person=3|Tense=Past|VerbForm=Fin
conscious	conscious	ADJ	Degree=Pos
Johnson	Johnson	PROPN	Number=Sing
shower	shower	NOUN	Number=Sing
instance	instance	NOUN	Number=Sing
running	run	VERB	VerbForm=Ger
running	run	VERB	Tense=Pres|VerbForm=Part
California	California	PROPN	Number=Sing
60	60	NUM	NumType=Card
until	until	ADP	_
until	until	SCONJ	_
fabric	fabric	NOUN	Number=Sing
tens	ten	NOUN	Number=Plur
Business	Business	PROPN	Number=Sing
knowledge	knowledge	NOUN	Number=Sing
cities	city	NOUN	Number=Plur
fundamentalist	fundamentalist	ADJ	Degree=Pos
delay	delay	NOUN	Number=Sing
particular	particular	ADJ	Degree=Pos
far	far	ADV	Degree=Pos
far	far	ADJ	Degree=Pos
shoe	shoe	NOUN	Number=Sing
table	table	NOUN	Number=Sing
airfare	airfare	NOUN	Number=Sing
candidate	candidate	NOUN	Number=Sing
crisis	crisis	NOUN	Number=Sing
cost	cost	VERB	VerbForm=Inf
cost	cost	NOUN	Number=Sing
covered	cover	VERB	Tense=Past|VerbForm=Part|Voice=Pass
McDonald	McDonald	PROPN	Number=Sing
Holy	Holy	PROPN	Number=Sing
Be	be	AUX	Mood=Imp|VerbForm=Fin
dentist	dentist	NOUN	Number=Sing
weather	weather	NOUN	Number=Sing
concerned	concerned	ADJ	Degree=Pos
Center	Center	PROPN	Number=Sing
fax	fax	VERB	VerbForm=Inf
fax	fax	NOUN	Number=Sing
stars	star	NOUN	Number=Plur
competitive	competitive	ADJ	Degree=Pos
expense	expense	NOUN	Number=Sing
guest	guest	NOUN	Number=Sing
think	think	VERB	Mood=Ind|Tense=Pres|VerbForm=Fin
think	think	VERB	Mood=Imp|VerbForm=Fin
think	think	VERB	VerbForm=Inf
Baghdad	Baghdad	PROPN	Number=Sing
stolen	steal	VERB	Tense=Past|VerbForm=Part
executed	execute	VERB	Tense=Past|VerbForm=Part
round	round	NOUN	Number=Sing
bed	bed	NOUN	Number=Sing
17	17	NUM	NumType=Card
sources	source	NOUN	Number=Plur
decades	decade	NOUN	Number=Plur
Ryan	Ryan	PROPN	Number=Sing
excellent	excellent	ADJ	Degree=Pos
Bangladesh	Bangladesh	PROPN	Number=Sing
Of	of	ADP	_
Of	of	ADV	_
sheet	sheet	NOUN	Number=Sing
Marketing	Marketing	PROPN	Number=Sing
say	say	VERB	Mood=Ind|Tense=Pres|VerbForm=Fin
say	say	VERB	Mood=Imp|VerbForm=Fin
say	say	VERB	VerbForm=Inf
Kathleen	Kathleen	PROPN	Number=Sing
Mann	Mann	PROPN	Number=Sing
whether	whether	SCONJ	_
p.m.	p.m.	NOUN	Number=Sing
civilians	civilian	NOUN	Number=Plur
frequent	frequent	ADJ	Degree=Pos
execution	execution	NOUN	Number=Sing
else	else	ADJ	Degree=Pos
else	else	ADV	_
traders	trader	NOUN	Number=Plur
REALLY	really	ADV	_
two	two	NUM	NumType=Card
actual	actual	ADJ	Degree=Pos
sent	send	VERB	Tense=Past|VerbForm=Part
sent	send	VERB	Tense=Past|VerbForm=Part|Voice=Pass
sent	send	VERB	Mood=Ind|Tense=Past|VerbForm=Fin
meaning	mean	VERB	VerbForm=Ger
meaning	meaning	NOUN	Number=Sing
works	work	VERB	Mood=Ind|Number=Sing|Person=3|Tense=Pres|VerbForm=Fin
works	work	NOUN	Number=Plur
image	image	NOUN	Number=Sing
LTTE	LTTE	PROPN	Number=Sing
dirty	dirty	ADJ	Degree=Pos
master	master	NOUN	Number=Sing
fire	fire	NOUN	Number=Sing
here	here	ADV	PronType=Dem
Kathy	Kathy	PROPN	Number=Sing
regions	region	NOUN	Number=Plur
best	best	ADV	Degree=Sup
best	best	ADJ	Degree=Sup
entire	entire	ADJ	Degree=Pos
taxes	tax	NOUN	Number=Plur
bears	bear	NOUN	Number=Plur
Nov	Nov	PROPN	Number=Sing
6:00	6:00	NUM	NumType=Card
born	bear	VERB	Tense=Past|VerbForm=Part
born	bear	VERB	Tense=Past|VerbForm=Part|Voice=Pass
Audit	audit	NOUN	Number=Sing
11	11	NUM	NumType=Card
talent	talent	NOUN	Number=Sing
God	God	PROPN	Number=Sing
!!!	!!!	PUNCT	_
included	include	VERB	Tense=Past|VerbForm=Part|Voice=Pass
included	include	VERB	Mood=Ind|Tense=Past|VerbForm=Fin
mean	mean	VERB	Mood=Ind|Tense=Pres|VerbForm=Fin
mean	mean	VERB	VerbForm=Inf
AMAZING	amazing	ADJ	Degree=Pos
chair	chair	NOUN	Number=Sing
------	------	PUNCT	_
leadership	leadership	NOUN	Number=Sing
WHAT	what	PRON	PronType=Int
she	she	PRON	Case=Nom|Gender=Fem|Number=Sing|Person=3|PronType=Prs
Louisiana	Louisiana	PROPN	Number=Sing
attack	attack	NOUN	Number=Sing
helping	help	VERB	VerbForm=Ger
01/26/2001	01/26/2001	NUM	NumType=Card
belief	belief	NOUN	Number=Sing
updated	update	VERB	Tense=Past|VerbForm=Part
affair	affair	NOUN	Number=Sing
same	same	ADJ	Degree=Pos
rice	rice	NOUN	Number=Sing
house	house	NOUN	Number=Sing
conditions	condition	NOUN	Number=Plur
regional	regional	ADJ	Degree=Pos
room	room	NOUN	Number=Sing
wear	wear	VERB	VerbForm=Inf
almost	almost	ADV	_
might	might	AUX	VerbForm=Fin
facing	face	VERB	Tense=Pres|VerbForm=Part
Currently	currently	ADV	_
continued	continue	VERB	Mood=Ind|Tense=Past|VerbForm=Fin
continued	continue	VERB	Tense=Past|VerbForm=Part
technology	technology	NOUN	Number=Sing
wo	will	AUX	VerbForm=Fin
dine	dine	VERB	VerbForm=Inf
2012	2012	NUM	NumType=Card
Party	Party	PROPN	Number=Sing
Party	party	NOUN	Number=Sing
bring	bring	VERB	VerbForm=Inf
thanks	thanks	NOUN	Number=Plur
thanks	thanks	NOUN	Number=Sing
supporters	supporter	NOUN	Number=Plur
cancel	cancel	VERB	VerbForm=Inf
hungry	hungry	ADJ	Degree=Pos
score	score	NOUN	Number=Sing
long	long	ADV	Degree=Pos
long	long	ADJ	Degree=Pos
800	800	NUM	NumType=Card
Corp	Corp	PROPN	Number=Sing
opened	open	VERB	Mood=Ind|Tense=Past|VerbForm=Fin
LOI	loi	NOUN	Number=Sing
purchased	purchase	VERB	Tense=Past|VerbForm=Part
purchased	purchase	VERB	Mood=Ind|Tense=Past|VerbForm=Fin
Sharon	Sharon	PROPN	Number=Sing
Â·	Â·	PUNCT	_
previous	previous	ADJ	Degree=Pos
terrorists	terrorist	NOUN	Number=Plur
obviously	obviously	ADV	_
Management	management	NOUN	Number=Sing
speakers	speaker	NOUN	Number=Plur
laws	law	NOUN	Number=Plur
standard	standard	ADJ	Degree=Pos
standard	standard	NOUN	Number=Sing
student	student	NOUN	Number=Sing
Japanese	japanese	ADJ	Degree=Pos
travelling	travel	VERB	VerbForm=Ger
sights	sight	NOUN	Number=Plur
inexpensive	inexpensive	ADJ	Degree=Pos
Peter	Peter	PROPN	Number=Sing
oldest	oldest	ADJ	Degree=Sup
actually	actually	ADV	_
vacation	vacation	NOUN	Number=Sing
reports	report	VERB	Mood=Ind|Number=Sing|Person=3|Tense=Pres|VerbForm=Fin
reports	report	NOUN	Number=Plur
anthrax	anthrax	NOUN	Number=Sing
Michael	Michael	PROPN	Number=Sing
scared	scared	ADJ	Degree=Pos
telling	tell	VERB	VerbForm=Ger
noise	noise	NOUN	Number=Sing
Today	today	NOUN	Number=Sing
understanding	understanding	NOUN	Number=Sing
spreadsheet	spreadsheet	NOUN	Number=Sing
Denton	Denton	PROPN	Number=Sing
possibility	possibility	NOUN	Number=Sing
based	base	VERB	Tense=Past|VerbForm=Part
based	base	VERB	Tense=Past|VerbForm=Part|Voice=Pass
cake	cake	NOUN	Number=Sing
alternative	alternative	ADJ	Degree=Pos
alternative	alternative	NOUN	Number=Sing
Every	every	DET	_
Rod	Rod	PROPN	Number=Sing
:)	:)	SYM	_
ME	I	PRON	Case=Acc|Number=Sing|Person=1|PronType=Prs
got	get	VERB	Tense=Past|VerbForm=Part
got	get	VERB	Mood=Ind|Tense=Past|VerbForm=Fin
got	get	AUX	Mood=Ind|Tense=Past|VerbForm=Fin
Make	make	VERB	Mood=Imp|VerbForm=Fin
content	content	NOUN	Number=Sing
Dallas	Dallas	PROPN	Number=Sing
TO	to	PART	_
TO	to	ADP	_
Washington	Washington	PROPN	Number=Sing
should	should	AUX	VerbForm=Fin
Would	would	AUX	VerbForm=Fin
informed	inform	VERB	Mood=Ind|Tense=Past|VerbForm=Fin
informed	inform	VERB	Tense=Past|VerbForm=Part|Voice=Pass
informed	inform	VERB	Tense=Past|VerbForm=Part
Alabama	Alabama	PROPN	Number=Sing
highly	highly	ADV	_
lost	lose	VERB	Mood=Ind|Tense=Past|VerbForm=Fin
lost	lose	VERB	Tense=Past|VerbForm=Part
division	division	NOUN	Number=Sing
mice	mouse	NOUN	Number=Plur
certain	certain	ADJ	Degree=Pos
case	case	NOUN	Number=Sing
worse	worse	ADJ	Degree=Cmp
photos	photo	NOUN	Number=Plur
also	also	ADV	_
Specialist	specialist	NOUN	Number=Sing
Iraqi	iraqi	ADJ	Degree=Pos
Iraqi	Iraqi	PROPN	Number=Sing
following	follow	VERB	VerbForm=Ger
presentation	presentation	NOUN	Number=Sing
difference	difference	NOUN	Number=Sing
Currency	currency	NOUN	Number=Sing
fiction	fiction	NOUN	Number=Sing
aside	aside	ADV	_
mail	mail	NOUN	Number=Sing
---	---	PUNCT	_
least	least	ADV	Degree=Sup
Hamas	Hamas	PROPN	Number=Sing
counter	counter	NOUN	Number=Sing
reservation	reservation	NOUN	Number=Sing
totally	totally	ADV	_
53	53	NUM	NumType=Card
LLC	LLC	PROPN	Number=Sing
permission	permission	NOUN	Number=Sing
refused	refuse	VERB	Mood=Ind|Tense=Past|VerbForm=Fin
adults	adult	NOUN	Number=Plur
serving	serve	VERB	VerbForm=Ger
stuck	stuck	ADJ	Degree=Pos
drill	drill	NOUN	Number=Sing
Percentage	percentage	NOUN	Number=Sing
event	event	NOUN	Number=Sing
visitors	visitor	NOUN	Number=Plur
costs	cost	NOUN	Number=Plur
costs	cost	VERB	Mood=Ind|Number=Sing|Person=3|Tense=Pres|VerbForm=Fin
stayed	stay	VERB	Tense=Past|VerbForm=Part
stayed	stay	VERB	Mood=Ind|Tense=Past|VerbForm=Fin
thing	thing	NOUN	Number=Sing
beings	being	NOUN	Number=Plur
Qaeda	Qaeda	PROPN	Number=Sing
alliance	alliance	NOUN	Number=Sing
mass	mass	ADJ	Degree=Pos
â€¦	.	PUNCT	_
risk	risk	NOUN	Number=Sing
wood	wood	NOUN	Number=Sing
drug	drug	NOUN	Number=Sing
Kyle	Kyle	PROPN	Number=Sing
Americans	Americans	PROPN	Number=Plur
attempt	attempt	NOUN	Number=Sing
copies	copy	NOUN	Number=Plur
numbers	number	NOUN	Number=Plur
shot	shot	NOUN	Number=Sing
Microsoft	Microsoft	PROPN	Number=Sing
returned	return	VERB	Tense=Past|VerbForm=Part
returned	return	VERB	Mood=Ind|Tense=Past|VerbForm=Fin
Nook	Nook	PROPN	Number=Sing
along	along	ADP	_
along	along	ADV	_
poverty	poverty	NOUN	Number=Sing
sounds	sound	VERB	Mood=Ind|Number=Sing|Person=3|Tense=Pres|VerbForm=Fin
Dr	Dr	PROPN	Number=Sing
Hambali	Hambali	PROPN	Number=Sing
again	again	ADV	_
A.	A.	PROPN	Number=Sing
of	of	ADP	_
of	of	SCONJ	_
of	of	ADV	_
sexual	sexual	ADJ	Degree=Pos
revised	revise	VERB	Tense=Past|VerbForm=Part
dating	dating	NOUN	Number=Sing
Metro	Metro	PROPN	Number=Sing
Hello	hello	INTJ	_
operation	operation	NOUN	Number=Sing
feeling	feeling	NOUN	Number=Sing
feeling	feel	VERB	VerbForm=Ger
mechanic	mechanic	NOUN	Number=Sing
public	public	ADJ	Degree=Pos
Thailand	Thailand	PROPN	Number=Sing
USA	USA	PROPN	Number=Sing
Administrative	administrative	ADJ	Degree=Pos
runs	run	VERB	Mood=Ind|Number=Sing|Person=3|Tense=Pres|VerbForm=Fin
printing	printing	NOUN	Number=Sing
finance	finance	NOUN	Number=Sing
Traci	Traci	PROPN	Number=Sing
Mom	mom	NOUN	Number=Sing
barely	barely	ADV	_
dealership	dealership	NOUN	Number=Sing
Buenos	Buenos	PROPN	Number=Sing
child	child	NOUN	Number=Sing
mosques	mosque	NOUN	Number=Plur
listen	listen	VERB	VerbForm=Inf
forward	forward	ADJ	Degree=Pos
forward	forward	VERB	Mood=Imp|VerbForm=Fin
forward	forward	VERB	VerbForm=Inf
forward	forward	ADV	_
satisfactory	satisfactory	ADJ	Degree=Pos
analyst	analyst	NOUN	Number=Sing
reported	report	VERB	Mood=Ind|Tense=Past|VerbForm=Fin
reported	report	VERB	Tense=Past|VerbForm=Part|Voice=Pass
requirement	requirement	NOUN	Number=Sing
responses	response	NOUN	Number=Plur
Walker	Walker	PROPN	Number=Sing
performance	performance	NOUN	Number=Sing
W	W	PROPN	Number=Sing
Mexican	mexican	ADJ	Degree=Pos
re	re	ADP	_
re	be	AUX	Mood=Ind|Tense=Pres|VerbForm=Fin
his	he	PRON	Gender=Masc|Number=Sing|Person=3|Poss=Yes|PronType=Prs
rooms	room	NOUN	Number=Plur
going	go	VERB	VerbForm=Ger
going	go	VERB	Tense=Pres|VerbForm=Part
To	to	PART	_
To	to	ADP	_
happened	happen	VERB	Mood=Ind|Tense=Past|VerbForm=Fin
horse	horse	NOUN	Number=Sing
mark	mark	NOUN	Number=Sing
mark	mark	VERB	VerbForm=Inf
studio	studio	NOUN	Number=Sing
built	build	VERB	Tense=Past|VerbForm=Part
recent	recent	ADJ	Degree=Pos
Blount	Blount	PROPN	Number=Sing
explain	explain	VERB	VerbForm=Inf
consideration	consideration	NOUN	Number=Sing
food	food	NOUN	Number=Sing
FREE	free	ADJ	Degree=Pos
broke	break	VERB	Mood=Ind|Tense=Past|VerbForm=Fin
remember	remember	VERB	Mood=Ind|Tense=Pres|VerbForm=Fin
remember	remember	VERB	Mood=Imp|VerbForm=Fin
remember	remember	VERB	VerbForm=Inf
holding	hold	VERB	Tense=Pres|VerbForm=Part
holding	hold	VERB	VerbForm=Ger
Janette	Janette	PROPN	Number=Sing
Calgary	Calgary	PROPN	Number=Sing
referenced	reference	VERB	Tense=Past|VerbForm=Part
Obviously	obviously	ADV	_
Like	like	ADP	_
among	among	ADP	_
tip	tip	NOUN	Number=Sing
ever	ever	ADV	_
expertise	expertise	NOUN	Number=Sing
document	document	NOUN	Number=Sing
October	October	PROPN	Number=Sing
Did	do	AUX	Mood=Ind|Tense=Past|VerbForm=Fin
outstanding	outstanding	ADJ	Degree=Pos
gallon	gallon	NOUN	Number=Sing
considered	consider	VERB	Mood=Ind|Tense=Past|VerbForm=Fin
considered	consider	VERB	Tense=Past|VerbForm=Part|Voice=Pass
considered	consider	VERB	Tense=Past|VerbForm=Part
pointed	point	VERB	Mood=Ind|Tense=Past|VerbForm=Fin
Took	take	VERB	Mood=Ind|Tense=Past|VerbForm=Fin
mountain	mountain	NOUN	Number=Sing
requested	request	VERB	Tense=Past|VerbForm=Part
requested	request	VERB	Mood=Ind|Tense=Past|VerbForm=Fin
713-853-3989	713-853-3989	NUM	NumType=Card
course	course	ADV	_
course	course	NOUN	Number=Sing
1:00	1:00	NUM	NumType=Card
Article	article	NOUN	Number=Sing
45	45	NUM	NumType=Card
crime	crime	NOUN	Number=Sing
accept	accept	VERB	VerbForm=Inf
issue	issue	NOUN	Number=Sing
believe	believe	VERB	VerbForm=Inf
believe	believe	VERB	Mood=Ind|Tense=Pres|VerbForm=Fin
year	year	NOUN	Number=Sing
growing	grow	VERB	VerbForm=Ger
Look	look	VERB	Mood=Imp|VerbForm=Fin
mind	mind	VERB	VerbForm=Inf
mind	mind	NOUN	Number=Sing
required	require	VERB	Tense=Past|VerbForm=Part
required	require	VERB	Tense=Past|VerbForm=Part|Voice=Pass
plain	plain	ADJ	Degree=Pos
section	section	NOUN	Number=Sing
Stuart	Stuart	PROPN	Number=Sing
order	order	VERB	VerbForm=Inf
order	order	VERB	Mood=Ind|Tense=Pres|VerbForm=Fin
order	order	NOUN	Number=Sing
Agra	Agra	PROPN	Number=Sing
necessarily	necessarily	ADV	_
senior	senior	ADJ	Degree=Pos
Jana	Jana	PROPN	Number=Sing
cars	car	NOUN	Number=Plur
strike	strike	NOUN	Number=Sing
Sunburn	Sunburn	PROPN	Number=Sing
expansion	expansion	NOUN	Number=Sing
HPL	HPL	PROPN	Number=Sing
club	club	NOUN	Number=Sing
plenty	plenty	NOUN	Number=Sing
fan	fan	NOUN	Number=Sing
Its	its	PRON	Gender=Neut|Number=Sing|Person=3|Poss=Yes|PronType=Prs
south	south	NOUN	Number=Sing
south	south	ADV	_
fighting	fighting	NOUN	Number=Sing
fighting	fight	VERB	VerbForm=Ger
Hotline	hotline	NOUN	Number=Sing
percent	percent	NOUN	Number=Sing
pup	pup	NOUN	Number=Sing
currently	currently	ADV	_
escape	escape	VERB	VerbForm=Inf
CDEC	CDEC	PROPN	Number=Sing
Control	Control	PROPN	Number=Sing
efficient	efficient	ADJ	Degree=Pos
presence	presence	NOUN	Number=Sing
allow	allow	VERB	VerbForm=Inf
capabilities	capability	NOUN	Number=Plur
welcome	welcome	ADJ	Degree=Pos
Guild	Guild	PROPN	Number=Sing
Floating	float	VERB	VerbForm=Ger
DISCO	DISCO	PROPN	Number=Sing
drink	drink	VERB	VerbForm=Inf
indeed	indeed	ADV	_
Big	Big	PROPN	Number=Sing
Big	big	ADJ	Degree=Pos
Don	Don	PROPN	Number=Sing
northern	northern	ADJ	Degree=Pos
condition	condition	NOUN	Number=Sing
forever	forever	ADV	_
those	those	DET	Number=Plur|PronType=Dem
those	those	PRON	Number=Plur|PronType=Dem
older	older	ADJ	Degree=Cmp
situation	situation	NOUN	Number=Sing
film	film	NOUN	Number=Sing
go	go	VERB	VerbForm=Inf
go	go	VERB	Mood=Imp|VerbForm=Fin
go	go	VERB	Mood=Ind|Tense=Pres|VerbForm=Fin
muscles	muscle	NOUN	Number=Plur
experienced	experienced	ADJ	Degree=Pos
vs.	vs.	ADP	_
freeze	freeze	NOUN	Number=Sing
beyond	beyond	ADV	_
beyond	beyond	ADP	_
pay	pay	VERB	VerbForm=Inf
pay	pay	VERB	Mood=Ind|Tense=Pres|VerbForm=Fin
surgeon	surgeon	NOUN	Number=Sing
can	can	AUX	VerbForm=Fin
can	can	NOUN	Number=Sing
town	town	NOUN	Number=Sing
Army	Army	PROPN	Number=Sing
Kuwait	Kuwait	PROPN	Number=Sing
Andaman	Andaman	PROPN	Number=Sing
Will	will	AUX	VerbForm=Fin
waiter	waiter	NOUN	Number=Sing
bigger	bigger	ADJ	Degree=Cmp
operations	operation	NOUN	Number=Plur
Year	Year	PROPN	Number=Sing
Year	year	NOUN	Number=Sing
Thursday	Thursday	PROPN	Number=Sing
facts	fact	NOUN	Number=Plur
commercial	commercial	ADJ	Degree=Pos
purchasing	purchase	VERB	VerbForm=Ger
India	India	PROPN	Number=Sing
National	national	ADJ	Degree=Pos
National	National	PROPN	Number=Sing
Re	re	ADP	_
newly	newly	ADV	_
agents	agent	NOUN	Number=Plur
proper	proper	ADJ	Degree=Pos
Craig	Craig	PROPN	Number=Sing
PG&E	PG&E	PROPN	Number=Sing
German	german	ADJ	Degree=Pos
described	describe	VERB	Tense=Past|VerbForm=Part
doubt	doubt	VERB	Mood=Ind|Tense=Pres|VerbForm=Fin
doubt	doubt	NOUN	Number=Sing
Defence	Defence	PROPN	Number=Sing
reputation	reputation	NOUN	Number=Sing
According	accord	VERB	VerbForm=Ger
neighbourhood	neighbourhood	NOUN	Number=Sing
rough	rough	ADJ	Degree=Pos
stands	stand	VERB	Mood=Ind|Number=Sing|Person=3|Tense=Pres|VerbForm=Fin
response	response	NOUN	Number=Sing
Day	Day	PROPN	Number=Sing
LOT	lot	NOUN	Number=Sing
Hu	Hu	PROPN	Number=Sing
ourselves	ourselves	PRON	Case=Acc|Number=Plur|Person=1|PronType=Prs|Reflex=Yes
85	85	NUM	NumType=Card
assets	asset	NOUN	Number=Plur
each	each	DET	_
directly	directly	ADV	_
finger	finger	NOUN	Number=Sing
these	these	PRON	Number=Plur|PronType=Dem
these	these	DET	Number=Plur|PronType=Dem
Karzai	Karzai	PROPN	Number=Sing
Carnival	Carnival	PROPN	Number=Sing
social	social	ADJ	Degree=Pos
class	class	NOUN	Number=Sing
towards	towards	ADP	_
side	side	NOUN	Number=Sing
headquarters	headquarters	NOUN	Number=Plur
doctor	doctor	NOUN	Number=Sing
Independent	independent	ADJ	Degree=Pos
Scott	Scott	PROPN	Number=Sing
communities	community	NOUN	Number=Plur
blog	blog	NOUN	Number=Sing
Liberty	Liberty	PROPN	Number=Sing
either	either	ADV	_
either	either	CCONJ	_
either	either	DET	_
<	<	PUNCT	_
reach	reach	VERB	VerbForm=Inf
list	list	NOUN	Number=Sing
That	that	PRON	Number=Sing|PronType=Dem
That	that	SCONJ	_
That	that	DET	Number=Sing|PronType=Dem
intended	intend	VERB	Tense=Past|VerbForm=Part|Voice=Pass
intended	intend	VERB	Tense=Past|VerbForm=Part
How	how	ADV	PronType=Int
named	name	VERB	Tense=Past|VerbForm=Part
Give	give	VERB	Mood=Imp|VerbForm=Fin
Spain	Spain	PROPN	Number=Sing
COMMUNICATIONS	communications	X	_
likely	likely	ADJ	Degree=Pos
likely	likely	ADV	_
practice	practice	NOUN	Number=Sing
Wolfowitz	Wolfowitz	PROPN	Number=Sing
timely	timely	ADJ	Degree=Pos
scheduled	schedule	VERB	Tense=Past|VerbForm=Part|Voice=Pass
scheduled	schedule	VERB	Tense=Past|VerbForm=Part
banks	bank	NOUN	Number=Plur
75	75	NUM	NumType=Card
;	;	PUNCT	_
2008	2008	NUM	NumType=Card
return	return	NOUN	Number=Sing
return	return	VERB	VerbForm=Inf
markets	market	NOUN	Number=Plur
marketers	marketer	NOUN	Number=Plur
Neal	Neal	PROPN	Number=Sing
privileged	privileged	ADJ	Degree=Pos
step	step	NOUN	Number=Sing
step	step	VERB	VerbForm=Inf
41	41	NUM	NumType=Card
entertainment	entertainment	NOUN	Number=Sing
speed	speed	NOUN	Number=Sing
fantastic	fantastic	ADJ	Degree=Pos
interest	interest	NOUN	Number=Sing
Paul	Paul	PROPN	Number=Sing
through	through	ADV	_
through	through	ADP	_
few	few	ADJ	Degree=Pos
account	account	NOUN	Number=Sing
cat	cat	NOUN	Number=Sing
caught	catch	VERB	Tense=Past|VerbForm=Part|Voice=Pass
create	create	VERB	VerbForm=Inf
Their	they	PRON	Number=Plur|Person=3|Poss=Yes|PronType=Prs
Rights	rights	NOUN	Number=Plur
threw	throw	VERB	Mood=Ind|Tense=Past|VerbForm=Fin
Hall	Hall	PROPN	Number=Sing
toxic	toxic	ADJ	Degree=Pos
hopefully	hopefully	ADV	_
>>	>>	PUNCT	_
appropriate	appropriate	ADJ	Degree=Pos
friend	friend	NOUN	Number=Sing
spent	spend	VERB	Mood=Ind|Tense=Past|VerbForm=Fin
spent	spend	VERB	Tense=Past|VerbForm=Part
prime	prime	ADJ	Degree=Pos
IN	in	ADP	_
outside	outside	ADV	_
outside	outside	ADJ	Degree=Pos
outside	outside	ADP	_
System	system	NOUN	Number=Sing
Could	could	AUX	VerbForm=Fin
data	data	NOUN	Number=Sing
wanting	want	VERB	VerbForm=Ger
reserves	reserve	NOUN	Number=Plur
month	month	NOUN	Number=Sing
crap	crap	NOUN	Number=Sing
participate	participate	VERB	VerbForm=Inf
Food	food	NOUN	Number=Sing
itself	itself	PRON	Gender=Neut|Number=Sing|Person=3|PronType=Prs
itself	itself	PRON	Case=Acc|Gender=Neut|Number=Sing|Person=3|PronType=Prs|Reflex=Yes
North	North	PROPN	Number=Sing
foreigners	foreigner	NOUN	Number=Plur
bus	bus	NOUN	Number=Sing
placed	place	VERB	Tense=Past|VerbForm=Part
still	still	ADV	_
provides	provide	VERB	Mood=Ind|Number=Sing|Person=3|Tense=Pres|VerbForm=Fin
VCU	VCU	PROPN	Number=Sing
slice	slice	NOUN	Number=Sing
at	at	SCONJ	_
at	at	ADV	_
at	at	ADP	_
Jesus	Jesus	PROPN	Number=Sing
free	free	ADJ	Degree=Pos
local	local	ADJ	Degree=Pos
Director	director	NOUN	Number=Sing
reporting	report	VERB	VerbForm=Ger
ok	ok	ADJ	Degree=Pos
Rob	Rob	PROPN	Number=Sing
NT	not	PART	_
type	type	NOUN	Number=Sing
legitimate	legitimate	ADJ	Degree=Pos
role	role	NOUN	Number=Sing
severe	severe	ADJ	Degree=Pos
I	I	PRON	Case=Nom|Number=Sing|Person=1|PronType=Prs
Kabul	Kabul	PROPN	Number=Sing
Wonderful	wonderful	ADJ	Degree=Pos
Arabia	Arabia	PROPN	Number=Sing
TX	TX	PROPN	Number=Sing
warmth	warmth	NOUN	Number=Sing
adding	add	VERB	VerbForm=Ger
drugs	drug	NOUN	Number=Plur
kittens	kitten	NOUN	Number=Plur
heat	heat	NOUN	Number=Sing
scary	scary	ADJ	Degree=Pos
estimated	estimate	VERB	Tense=Past|VerbForm=Part
replacement	replacement	NOUN	Number=Sing
McCartney	McCartney	PROPN	Number=Sing
FOOD	food	NOUN	Number=Sing
Island	Island	PROPN	Number=Sing
Miami	Miami	PROPN	Number=Sing
basic	basic	ADJ	Degree=Pos
5:00	5:00	NUM	NumType=Card
yellow	yellow	ADJ	Degree=Pos
funds	fund	NOUN	Number=Plur
somehow	somehow	ADV	_
This	this	DET	Number=Sing|PronType=Dem
This	this	PRON	Number=Sing|PronType=Dem
crowd	crowd	NOUN	Number=Sing
Notice	notice	NOUN	Number=Sing
essentially	essentially	ADV	_
Sunnis	Sunnis	PROPN	Number=Plur
A&E	A&E	PROPN	Number=Sing
reality	reality	NOUN	Number=Sing
look	look	VERB	Mood=Ind|Tense=Pres|VerbForm=Fin
look	look	VERB	VerbForm=Inf
look	look	NOUN	Number=Sing
look	look	VERB	Mood=Imp|VerbForm=Fin
audit	audit	NOUN	Number=Sing
bought	buy	VERB	Mood=Ind|Tense=Past|VerbForm=Fin
announced	announce	VERB	Mood=Ind|Tense=Past|VerbForm=Fin
announced	announce	VERB	Tense=Past|VerbForm=Part|Voice=Pass
announced	announce	VERB	Tense=Past|VerbForm=Part
1998	1998	NUM	NumType=Card
teacher	teacher	NOUN	Number=Sing
alcohol	alcohol	NOUN	Number=Sing
Thanks	thanks	NOUN	Number=Sing
incredibly	incredibly	ADV	_
database	database	NOUN	Number=Sing
lifetime	lifetime	NOUN	Number=Sing
individual	individual	ADJ	Degree=Pos
individual	individual	NOUN	Number=Sing
confused	confused	ADJ	Degree=Pos
WAS	be	AUX	Mood=Ind|Number=Sing|Person=3|Tense=Past|VerbForm=Fin
Take	take	VERB	Mood=Imp|VerbForm=Fin
photography	photography	NOUN	Number=Sing
Times	Times	PROPN	Number=Sing
Someone	someone	PRON	Number=Sing
urban	urban	ADJ	Degree=Pos
regards	regards	NOUN	Number=Plur
believed	believe	VERB	Mood=Ind|Tense=Past|VerbForm=Fin
returning	return	VERB	VerbForm=Ger
statement	statement	NOUN	Number=Sing
boyfriend	boyfriend	NOUN	Number=Sing
Division	division	NOUN	Number=Sing
crude	crude	NOUN	Number=Sing
OK	ok	INTJ	_
OK	ok	ADJ	Degree=Pos
kill	kill	VERB	VerbForm=Inf
key	key	ADJ	Degree=Pos
key	key	NOUN	Number=Sing
finally	finally	ADV	_
mostly	mostly	ADV	_
Since	since	ADP	_
Since	since	SCONJ	_
registration	registration	NOUN	Number=Sing
Vietnamese	vietnamese	ADJ	Degree=Pos
Israel	Israel	PROPN	Number=Sing
emergency	emergency	NOUN	Number=Sing
staff	staff	NOUN	Number=Plur
staff	staff	NOUN	Number=Sing
--	--	PUNCT	_
Leopold	Leopold	PROPN	Number=Sing
transmitted	transmit	VERB	Tense=Past|VerbForm=Part
spoke	speak	VERB	Mood=Ind|Tense=Past|VerbForm=Fin
felt	feel	VERB	Mood=Ind|Tense=Past|VerbForm=Fin
Nguyen	Nguyen	PROPN	Number=Sing
die	die	VERB	VerbForm=Inf
eaten	eat	VERB	Tense=Past|VerbForm=Part
earlier	earlier	ADJ	Degree=Cmp
earlier	earlier	ADV	_
earlier	earlier	ADV	Degree=Cmp
Osama	Osama	PROPN	Number=Sing
Wow	wow	INTJ	_
hoping	hope	VERB	Tense=Pres|VerbForm=Part
constantly	constantly	ADV	_
Jen	Jen	PROPN	Number=Sing
award	award	NOUN	Number=Sing
Prices	price	NOUN	Number=Plur
Congratulations	congratulation	NOUN	Number=Plur
plants	plant	NOUN	Number=Plur
Once	once	SCONJ	_
gene	gene	NOUN	Number=Sing
black	black	ADJ	Degree=Pos
kinds	kind	NOUN	Number=Plur
position	position	NOUN	Number=Sing
Syrian	syrian	ADJ	Degree=Pos
strain	strain	NOUN	Number=Sing
officially	officially	ADV	_
deposit	deposit	NOUN	Number=Sing
kick	kick	VERB	VerbForm=Inf
Sometimes	sometimes	ADV	_
business	business	NOUN	Number=Sing
chess	chess	NOUN	Number=Sing
Come	come	VERB	Mood=Imp|VerbForm=Fin
daily	daily	ADV	_
daily	daily	ADJ	Degree=Pos
try	try	VERB	Mood=Ind|Tense=Pres|VerbForm=Fin
try	try	VERB	VerbForm=Inf
try	try	VERB	Mood=Imp|VerbForm=Fin
near	near	ADP	_
near	near	ADJ	Degree=Pos
sympathy	sympathy	NOUN	Number=Sing
proposed	propose	VERB	Tense=Past|VerbForm=Part
images	image	NOUN	Number=Plur
accurate	accurate	ADJ	Degree=Pos
minutes	minute	NOUN	Number=Plur
backed	back	VERB	Tense=Past|VerbForm=Part
achieve	achieve	VERB	VerbForm=Inf
regular	regular	ADJ	Degree=Pos
Grill	Grill	PROPN	Number=Sing
customs	custom	NOUN	Number=Plur
worried	worried	ADJ	Degree=Pos
suddenly	suddenly	ADV	_
ga	ga	PROPN	Number=Sing
Moussaoui	Moussaoui	PROPN	Number=Sing
Silkies	silky	NOUN	Number=Plur
map	map	NOUN	Number=Sing
acceptable	acceptable	ADJ	Degree=Pos
much	much	ADV	_
much	much	ADJ	Degree=Pos
swap	swap	NOUN	Number=Sing
Shiites	Shiites	PROPN	Number=Plur
Kashmir	Kashmir	PROPN	Number=Sing
use	use	VERB	Mood=Imp|VerbForm=Fin
use	use	NOUN	Number=Sing
use	use	VERB	VerbForm=Inf
use	use	VERB	Mood=Ind|Tense=Pres|VerbForm=Fin
professionalism	professionalism	NOUN	Number=Sing
goes	go	VERB	Mood=Ind|Number=Sing|Person=3|Tense=Pres|VerbForm=Fin
letters	letter	NOUN	Number=Plur
Georgia	Georgia	PROPN	Number=Sing
Ahmed	Ahmed	PROPN	Number=Sing
feel	feel	VERB	Mood=Imp|VerbForm=Fin
feel	feel	NOUN	Number=Sing
feel	feel	VERB	Mood=Ind|Tense=Pres|VerbForm=Fin
feel	feel	VERB	VerbForm=Inf
BC	BC	PROPN	Number=Sing
rather	rather	ADV	_
rather	rather	ADP	_
brother	brother	NOUN	Number=Sing
Our	we	PRON	Number=Plur|Person=1|Poss=Yes|PronType=Prs
Harris	Harris	PROPN	Number=Sing
no	no	DET	_
no	no	INTJ	_
no	no	ADV	_
language	language	NOUN	Number=Sing
For	for	ADP	_
site	site	NOUN	Number=Sing
March	March	PROPN	Number=Sing
chose	choose	VERB	Mood=Ind|Tense=Past|VerbForm=Fin
10	10	NUM	NumType=Card
study	study	NOUN	Number=Sing
study	study	VERB	VerbForm=Inf
30	30	NUM	NumType=Card
involvement	involvement	NOUN	Number=Sing
increase	increase	NOUN	Number=Sing
increase	increase	VERB	VerbForm=Inf
unusual	unusual	ADJ	Degree=Pos
easily	easily	ADV	_
IS	be	AUX	Mood=Ind|Number=Sing|Person=3|Tense=Pres|VerbForm=Fin
IS	be	VERB	Mood=Ind|Number=Sing|Person=3|Tense=Pres|VerbForm=Fin
Plan	plan	NOUN	Number=Sing
structure	structure	NOUN	Number=Sing
female	female	ADJ	Degree=Pos
female	female	NOUN	Number=Sing
Privacy	privacy	NOUN	Number=Sing
Griffin	Griffin	PROPN	Number=Sing
plays	play	VERB	Mood=Ind|Number=Sing|Person=3|Tense=Pres|VerbForm=Fin
oh	oh	INTJ	_
arm	arm	NOUN	Number=Sing
English	English	PROPN	Number=Sing
Bobby	Bobby	PROPN	Number=Sing
ONLY	only	ADV	_
living	live	VERB	Tense=Pres|VerbForm=Part
living	living	NOUN	Number=Sing
living	live	VERB	VerbForm=Ger
uses	use	VERB	Mood=Ind|Number=Sing|Person=3|Tense=Pres|VerbForm=Fin
Q1	q1	NOUN	Number=Sing
prohibited	prohibit	VERB	Tense=Past|VerbForm=Part|Voice=Pass
females	female	NOUN	Number=Plur
station	station	NOUN	Number=Sing
satisfied	satisfied	ADJ	Degree=Pos
destroyed	destroy	VERB	Tense=Past|VerbForm=Part
Seattle	Seattle	PROPN	Number=Sing
biggest	biggest	ADJ	Degree=Sup
brass	brass	NOUN	Number=Sing
programme	programme	NOUN	Number=Sing
appeared	appear	VERB	Mood=Ind|Tense=Past|VerbForm=Fin
east	east	ADJ	Degree=Pos
surface	surface	NOUN	Number=Sing
valley	valley	NOUN	Number=Sing
Most	most	ADJ	Degree=Sup
Most	most	ADV	_
officers	officer	NOUN	Number=Plur
selling	sell	VERB	VerbForm=Ger
But	but	CCONJ	_
tire	tire	NOUN	Number=Sing
Nice	nice	ADJ	Degree=Pos
Nice	Nice	PROPN	Number=Sing
Joseph	Joseph	PROPN	Number=Sing
apologize	apologize	VERB	Mood=Ind|Tense=Pres|VerbForm=Fin
Nicobar	Nicobar	PROPN	Number=Sing
unless	unless	SCONJ	_
earth	earth	NOUN	Number=Sing
win	win	VERB	VerbForm=Inf
clothes	clothes	NOUN	Number=Plur
contacts	contact	NOUN	Number=Plur
efforts	effort	NOUN	Number=Plur
knife	knife	NOUN	Number=Sing
GDP	gdp	NOUN	Number=Sing
quite	quite	ADV	_
quite	quite	DET	_
Bay	Bay	PROPN	Number=Sing
executive	executive	ADJ	Degree=Pos
Also	also	ADV	_
interesting	interesting	ADJ	Degree=Pos
species	species	NOUN	Number=Plur
product	product	NOUN	Number=Sing
arrange	arrange	VERB	VerbForm=Inf
P.S.	p.s.	NOUN	Number=Sing
memory	memory	NOUN	Number=Sing
small	small	ADJ	Degree=Pos
armed	armed	ADJ	Degree=Pos
procedures	procedure	NOUN	Number=Plur
attention	attention	NOUN	Number=Sing
90	90	NUM	NumType=Card
University	University	PROPN	Number=Sing
began	begin	VERB	Mood=Ind|Tense=Past|VerbForm=Fin
access	access	NOUN	Number=Sing
access	access	VERB	VerbForm=Inf
Royal	Royal	PROPN	Number=Sing
low	low	ADJ	Degree=Pos
lead	lead	NOUN	Number=Sing
lead	lead	VERB	VerbForm=Inf
park	park	NOUN	Number=Sing
Austin	Austin	PROPN	Number=Sing
Credit	credit	NOUN	Number=Sing
Place	place	NOUN	Number=Sing
THIS	this	DET	Number=Sing|PronType=Dem
THIS	this	PRON	Number=Sing|PronType=Dem
Save	save	VERB	Mood=Imp|VerbForm=Fin
terror	terror	NOUN	Number=Sing
missiles	missile	NOUN	Number=Plur
simply	simply	ADV	_
expensive	expensive	ADJ	Degree=Pos
Sadr	Sadr	PROPN	Number=Sing
Northern	Northern	PROPN	Number=Sing
Web	web	NOUN	Number=Sing
convenient	convenient	ADJ	Degree=Pos
Arabs	Arabs	PROPN	Number=Plur
Tax	tax	NOUN	Number=Sing
statue	statue	NOUN	Number=Sing
family	family	NOUN	Number=Sing
workforce	workforce	NOUN	Number=Sing
experts	expert	NOUN	Number=Plur
naked	naked	ADJ	Degree=Pos
pick	pick	VERB	VerbForm=Inf
Atta	Atta	PROPN	Number=Sing
survived	survive	VERB	Mood=Ind|Tense=Past|VerbForm=Fin
favor	favor	NOUN	Number=Sing
carefully	carefully	ADV	_
Gray	Gray	PROPN	Number=Sing
rebels	rebel	NOUN	Number=Plur
woman	woman	NOUN	Number=Sing
conventional	conventional	ADJ	Degree=Pos
luck	luck	NOUN	Number=Sing
Phillip	Phillip	PROPN	Number=Sing
marry	marry	VERB	VerbForm=Inf
took	take	VERB	Mood=Ind|Tense=Past|VerbForm=Fin
checked	check	VERB	Tense=Past|VerbForm=Part
checked	check	VERB	Mood=Ind|Tense=Past|VerbForm=Fin
Pentagon	Pentagon	PROPN	Number=Sing
transfer	transfer	NOUN	Number=Sing
b	b	X	_
b	b	NUM	NumType=Card
brought	bring	VERB	Mood=Ind|Tense=Past|VerbForm=Fin
guess	guess	VERB	Mood=Ind|Tense=Pres|VerbForm=Fin
guess	guess	VERB	VerbForm=Inf
America	America	PROPN	Number=Sing
wrote	write	VERB	Mood=Ind|Tense=Past|VerbForm=Fin
used	use	VERB	Tense=Past|VerbForm=Part|Voice=Pass
used	used	ADJ	Degree=Pos
used	use	VERB	Tense=Past|VerbForm=Part
used	use	VERB	Mood=Ind|Tense=Past|VerbForm=Fin
summary	summary	NOUN	Number=Sing
inside	inside	NOUN	Number=Sing
inside	inside	ADV	_
inside	inside	ADP	_
then	then	ADV	PronType=Dem
then	than	ADP	Typo=Yes
superb	superb	ADJ	Degree=Pos
saw	see	VERB	Mood=Ind|Tense=Past|VerbForm=Fin
disappointed	disappointed	ADJ	Degree=Pos
internal	internal	ADJ	Degree=Pos
bloody	bloody	ADJ	Degree=Pos
slow	slow	ADJ	Degree=Pos
completed	complete	VERB	Tense=Past|VerbForm=Part
2006	2006	NUM	NumType=Card
abroad	abroad	ADV	_
Debra	Debra	PROPN	Number=Sing
transaction	transaction	NOUN	Number=Sing
entities	entity	NOUN	Number=Plur
Paula	Paula	PROPN	Number=Sing
resulting	result	VERB	VerbForm=Ger
though	though	ADV	_
though	though	SCONJ	_
tried	try	VERB	Tense=Past|VerbForm=Part
tried	try	VERB	Mood=Ind|Tense=Past|VerbForm=Fin
fabulous	fabulous	ADJ	Degree=Pos
Coast	Coast	PROPN	Number=Sing
rating	rating	NOUN	Number=Sing
Darrell	Darrell	PROPN	Number=Sing
are	be	AUX	Mood=Ind|Tense=Pres|VerbForm=Fin
are	be	VERB	Mood=Ind|Tense=Pres|VerbForm=Fin
Kaminski	Kaminski	PROPN	Number=Sing
carol.st.clair@enron.com	carol.st.clair@enron.com	X	_
No.	no.	NOUN	Number=Sing
yoga	yoga	NOUN	Number=Sing
women	woman	NOUN	Number=Plur
format	format	NOUN	Number=Sing
Venus	Venus	PROPN	Number=Sing
package	package	NOUN	Number=Sing
body	body	NOUN	Number=Sing
fix	fix	VERB	VerbForm=Inf
height	height	NOUN	Number=Sing
staying	stay	VERB	Tense=Pres|VerbForm=Part
finish	finish	VERB	VerbForm=Inf
boat	boat	NOUN	Number=Sing
assassination	assassination	NOUN	Number=Sing
completing	complete	VERB	VerbForm=Ger
extremists	extremist	NOUN	Number=Plur
treatments	treatment	NOUN	Number=Plur
Sat.	Sat.	PROPN	Number=Sing
interested	interested	ADJ	Degree=Pos
concluded	conclude	VERB	Mood=Ind|Tense=Past|VerbForm=Fin
0	0	NUM	NumType=Card
art	art	NOUN	Number=Sing
minimal	minimal	ADJ	Degree=Pos
Tigers	Tigers	PROPN	Number=Plur
off	off	ADP	_
off	off	ADV	_
tough	tough	ADJ	Degree=Pos
school	school	NOUN	Number=Sing
Cambodia	Cambodia	PROPN	Number=Sing
only	only	ADJ	Degree=Pos
only	only	ADV	_
not	not	PART	_
not	not	ADV	_
not	not	CCONJ	_
People	people	NOUN	Number=Plur
polar	polar	ADJ	Degree=Pos
approximately	approximately	ADV	_
easy	easy	ADJ	Degree=Pos
occupation	occupation	NOUN	Number=Sing
lessons	lesson	NOUN	Number=Plur
acting	act	VERB	VerbForm=Ger
receives	receive	VERB	Mood=Ind|Number=Sing|Person=3|Tense=Pres|VerbForm=Fin
apply	apply	VERB	VerbForm=Inf
Maybe	maybe	ADV	_
filed	file	VERB	Tense=Past|VerbForm=Part
filed	file	VERB	Mood=Ind|Tense=Past|VerbForm=Fin
FYI	fyi	ADV	_
tourists	tourist	NOUN	Number=Plur
authorities	authority	NOUN	Number=Plur
Oct.	Oct.	PROPN	Number=Sing
ONE	one	NUM	NumType=Card
sharing	share	VERB	VerbForm=Ger
deals	deal	NOUN	Number=Plur
behavior	behavior	NOUN	Number=Sing
Cheney	Cheney	PROPN	Number=Sing
Pricing	pricing	X	_
Ed	Ed	PROPN	Number=Sing
private	private	ADJ	Degree=Pos
check	check	VERB	VerbForm=Inf
check	check	VERB	Mood=Imp|VerbForm=Fin
check	check	NOUN	Number=Sing
Which	which	DET	PronType=Int
Which	which	PRON	PronType=Int
Over	over	ADP	_
Over	over	ADV	_
WHY	why	ADV	PronType=Int
7	7	NUM	NumType=Card
amounts	amount	NOUN	Number=Plur
paid	pay	VERB	Tense=Past|VerbForm=Part|Voice=Pass
paid	pay	VERB	Mood=Ind|Tense=Past|VerbForm=Fin
paid	pay	VERB	Tense=Past|VerbForm=Part
both	both	ADV	_
both	both	CCONJ	_
both	both	DET	_
terms	term	NOUN	Number=Plur
repairs	repair	NOUN	Number=Plur
Francisco	Francisco	PROPN	Number=Sing
m	be	AUX	Mood=Ind|Tense=Pres|VerbForm=Fin
m	m	NOUN	Number=Sing
m	m	NUM	NumType=Card
execute	execute	VERB	VerbForm=Inf
attorney	attorney	NOUN	Number=Sing
letter	letter	NOUN	Number=Sing
destroy	destroy	VERB	VerbForm=Inf
weekend	weekend	NOUN	Number=Sing
hearing	hear	VERB	VerbForm=Ger
hearing	hearing	NOUN	Number=Sing
keeps	keep	VERB	Mood=Ind|Number=Sing|Person=3|Tense=Pres|VerbForm=Fin
often	often	ADV	_
99	99	NUM	NumType=Card
i	i	PRON	Case=Nom|Number=Sing|Person=1|PronType=Prs
feels	feel	VERB	Mood=Ind|Number=Sing|Person=3|Tense=Pres|VerbForm=Fin
voice	voice	NOUN	Number=Sing
AND	and	CCONJ	_
strength	strength	NOUN	Number=Sing
told	tell	VERB	Tense=Past|VerbForm=Part
told	tell	VERB	Mood=Ind|Tense=Past|VerbForm=Fin
told	tell	VERB	Tense=Past|VerbForm=Part|Voice=Pass
existing	exist	VERB	VerbForm=Ger
video	video	NOUN	Number=Sing
understands	understand	VERB	Mood=Ind|Number=Sing|Person=3|Tense=Pres|VerbForm=Fin
FOR	for	ADP	_
world	world	NOUN	Number=Sing
President	President	PROPN	Number=Sing
President	president	NOUN	Number=Sing
visits	visit	NOUN	Number=Plur
e-mail	e-mail	NOUN	Number=Sing
separately	separately	ADV	_
Noida	Noida	PROPN	Number=Sing
Lake	Lake	PROPN	Number=Sing
drive	drive	VERB	VerbForm=Inf
suite	suite	NOUN	Number=Sing
lack	lack	NOUN	Number=Sing
French	french	ADJ	Degree=Pos
loves	love	VERB	Mood=Ind|Number=Sing|Person=3|Tense=Pres|VerbForm=Fin
forced	force	VERB	Tense=Past|VerbForm=Part
Clair	Clair	PROPN	Number=Sing
chief	chief	ADJ	Degree=Pos
chief	chief	NOUN	Number=Sing
production	production	NOUN	Number=Sing
monthly	monthly	ADJ	Degree=Pos
26th	26th	NOUN	Number=Sing
Store	store	NOUN	Number=Sing
13	13	NUM	NumType=Card
saying	say	VERB	VerbForm=Ger
saying	say	VERB	Tense=Pres|VerbForm=Part
date	date	NOUN	Number=Sing
circularisation	circularisation	NOUN	Number=Sing
department	department	NOUN	Number=Sing
recently	recently	ADV	_
becomes	become	VERB	Mood=Ind|Number=Sing|Person=3|Tense=Pres|VerbForm=Fin
Comets	Comets	PROPN	Number=Plur
complained	complain	VERB	Mood=Ind|Tense=Past|VerbForm=Fin
visit	visit	VERB	Mood=Imp|VerbForm=Fin
visit	visit	NOUN	Number=Sing
visit	visit	VERB	VerbForm=Inf
tell	tell	VERB	Mood=Ind|Tense=Pres|VerbForm=Fin
tell	tell	VERB	VerbForm=Inf
discuss	discuss	VERB	VerbForm=Inf
path	path	NOUN	Number=Sing
charge	charge	VERB	Mood=Ind|Tense=Pres|VerbForm=Fin
charge	charge	NOUN	Number=Sing
charge	charge	VERB	VerbForm=Inf
showing	show	VERB	VerbForm=Ger
imagine	imagine	VERB	VerbForm=Inf
mom	mom	NOUN	Number=Sing
!!!!!!!	!!!!!!!	PUNCT	_
If	if	SCONJ	_
EnronOnline	EnronOnline	PROPN	Number=Sing
materials	material	NOUN	Number=Plur
father	father	NOUN	Number=Sing
Lee	Lee	PROPN	Number=Sing
ve	have	AUX	Mood=Ind|Tense=Pres|VerbForm=Fin
treat	treat	NOUN	Number=Sing
treat	treat	VERB	Mood=Ind|Tense=Pres|VerbForm=Fin
treat	treat	VERB	VerbForm=Inf
balance	balance	NOUN	Number=Sing
Chairman	Chairman	PROPN	Number=Sing
Philippines	Philippines	PROPN	Number=Plur
significantly	significantly	ADV	_
billion	billion	NUM	NumType=Card
sure	sure	ADV	_
sure	sure	ADJ	Degree=Pos
know	know	VERB	Mood=Ind|Tense=Pres|VerbForm=Fin
know	know	VERB	VerbForm=Inf
yourself	yourself	PRON	Case=Acc|Number=Sing|Person=2|PronType=Prs|Reflex=Yes
spread	spread	VERB	VerbForm=Inf
properly	properly	ADV	_
u	u	PRON	_
developed	develop	VERB	Tense=Past|VerbForm=Part
All	all	DET	_
him	he	PRON	Case=Acc|Gender=Masc|Number=Sing|Person=3|PronType=Prs
seven	seven	NUM	NumType=Card
unable	unable	ADJ	Degree=Pos
opinions	opinion	NOUN	Number=Plur
incompetence	incompetence	NOUN	Number=Sing
idea	idea	NOUN	Number=Sing
whom	whom	PRON	PronType=Int
whom	whom	PRON	PronType=Rel
June	June	PROPN	Number=Sing
company	company	NOUN	Number=Sing
folks	folk	NOUN	Number=Plur
electrical	electrical	ADJ	Degree=Pos
reduced	reduce	VERB	Tense=Past|VerbForm=Part
benefit	benefit	NOUN	Number=Sing
benefit	benefit	VERB	VerbForm=Inf
ports	port	NOUN	Number=Plur
degree	degree	NOUN	Number=Sing
invitation	invitation	NOUN	Number=Sing
tragedy	tragedy	NOUN	Number=Sing
artists	artist	NOUN	Number=Plur
hospitality	hospitality	NOUN	Number=Sing
Sunday	Sunday	PROPN	Number=Sing
girlfriend	girlfriend	NOUN	Number=Sing
contain	contain	VERB	VerbForm=Inf
stage	stage	NOUN	Number=Sing
carry	carry	VERB	Mood=Ind|Tense=Pres|VerbForm=Fin
carry	carry	VERB	VerbForm=Inf
painting	painting	NOUN	Number=Sing
sky	sky	NOUN	Number=Sing
tourist	tourist	NOUN	Number=Sing
Fantastic	fantastic	ADJ	Degree=Pos
Attorney	attorney	NOUN	Number=Sing
exchange	exchange	NOUN	Number=Sing
playing	play	VERB	VerbForm=Ger
playing	play	VERB	Tense=Pres|VerbForm=Part
romantic	romantic	ADJ	Degree=Pos
minor	minor	ADJ	Degree=Pos
happier	happier	ADJ	Degree=Cmp
establishment	establishment	NOUN	Number=Sing
awesome	awesome	ADJ	Degree=Pos
ability	ability	NOUN	Number=Sing
it	it	PRON	Case=Acc|Gender=Neut|Number=Sing|Person=3|PronType=Prs
it	it	PRON	Case=Nom|Gender=Neut|Number=Sing|Person=3|PronType=Prs
Samuel	Samuel	PROPN	Number=Sing
â€™s	be	AUX	Mood=Ind|Number=Sing|Person=3|Tense=Pres|VerbForm=Fin
â€™s	's	PART	_
trained	train	VERB	Tense=Past|VerbForm=Part|Voice=Pass
trained	train	VERB	Tense=Past|VerbForm=Part
dinner	dinner	NOUN	Number=Sing
crimes	crime	NOUN	Number=Plur
Bad	bad	ADJ	Degree=Pos
petroleum	petroleum	NOUN	Number=Sing
E-mail	e-mail	NOUN	Number=Sing
finding	find	VERB	VerbForm=Ger
about	about	ADP	_
about	about	ADV	_
about	about	SCONJ	_
about	about	ADJ	Degree=Pos
Anne	Anne	PROPN	Number=Sing
pleased	pleased	ADJ	Degree=Pos
Moon	Moon	PROPN	Number=Sing
grew	grow	VERB	Mood=Ind|Tense=Past|VerbForm=Fin
circle	circle	NOUN	Number=Sing
sale	sale	NOUN	Number=Sing
explained	explain	VERB	Mood=Ind|Tense=Past|VerbForm=Fin
holidays	holiday	NOUN	Number=Plur
212	212	NUM	NumType=Card
YES	yes	INTJ	_
largest	largest	ADJ	Degree=Sup
connection	connection	NOUN	Number=Sing
Swift	Swift	PROPN	Number=Sing
canon	canon	PROPN	Number=Sing
Senate	Senate	PROPN	Number=Sing
necessary	necessary	ADJ	Degree=Pos
recruiting	recruiting	NOUN	Number=Sing
today	today	NOUN	Number=Sing
concept	concept	NOUN	Number=Sing
Argentina	Argentina	PROPN	Number=Sing
band	band	NOUN	Number=Sing
neither	neither	CCONJ	_
colors	color	NOUN	Number=Plur
Everything	everything	PRON	Number=Sing
third	third	ADJ	Degree=Pos|NumType=Ord
civil	civil	ADJ	Degree=Pos
feet	foot	NOUN	Number=Plur
Carol	Carol	PROPN	Number=Sing
US	US	PROPN	Number=Sing
huge	huge	ADJ	Degree=Pos
attachments	attachment	NOUN	Number=Plur
%	%	SYM	Number=Sing
tight	tight	ADJ	Degree=Pos
yet	yet	CCONJ	_
yet	yet	ADV	_
Her	she	PRON	Gender=Fem|Number=Sing|Person=3|Poss=Yes|PronType=Prs
highest	highest	ADJ	Degree=Sup
left	leave	VERB	Tense=Past|VerbForm=Part
left	leave	VERB	Tense=Past|VerbForm=Part|Voice=Pass
left	leave	VERB	Mood=Ind|Tense=Past|VerbForm=Fin
left	left	ADJ	Degree=Pos
Awesome	awesome	ADJ	Degree=Pos
Texas	Texas	PROPN	Number=Sing
skill	skill	NOUN	Number=Sing
creating	create	VERB	VerbForm=Ger
matters	matter	NOUN	Number=Plur
Toronto	Toronto	PROPN	Number=Sing
info	info	NOUN	Number=Sing
Planet	Planet	PROPN	Number=Sing
receive	receive	VERB	VerbForm=Inf
career	career	NOUN	Number=Sing
Vince	Vince	PROPN	Number=Sing
Heather	Heather	PROPN	Number=Sing
stupid	stupid	ADJ	Degree=Pos
:-)	:-)	SYM	_
ARE	be	AUX	Mood=Ind|Tense=Pres|VerbForm=Fin
NOW	now	ADV	_
contents	contents	NOUN	Number=Plur
plans	plan	NOUN	Number=Plur
examples	example	NOUN	Number=Plur
Elizabeth	Elizabeth	PROPN	Number=Sing
However	however	ADV	_
anymore	anymore	ADV	_
definitely	definitely	ADV	_
Jose	Jose	PROPN	Number=Sing
nt	not	PART	_
below	below	ADP	_
below	below	ADV	_
neighborhood	neighborhood	NOUN	Number=Sing
Family	Family	PROPN	Number=Sing
Family	family	NOUN	Number=Sing
greatly	greatly	ADV	_
Arctic	Arctic	PROPN	Number=Sing
full	full	ADJ	Degree=Pos
Highly	highly	ADV	_
bar	bar	NOUN	Number=Sing
VERY	very	ADV	_
sometimes	sometimes	ADV	_
periods	period	NOUN	Number=Plur
dollar	dollar	NOUN	Number=Sing
shuttle	shuttle	NOUN	Number=Sing
highway	highway	NOUN	Number=Sing
unlimited	unlimited	ADJ	Degree=Pos
doors	door	NOUN	Number=Plur
Seas	Seas	PROPN	Number=Plur
operative	operative	NOUN	Number=Sing
Edwards	Edwards	PROPN	Number=Sing
Satan	Satan	PROPN	Number=Sing
northeastern	northeastern	ADJ	Degree=Pos
outcome	outcome	NOUN	Number=Sing
truth	truth	NOUN	Number=Sing
proof	proof	NOUN	Number=Sing
white	white	ADJ	Degree=Pos
conversation	conversation	NOUN	Number=Sing
thinking	think	VERB	VerbForm=Ger
thinking	think	VERB	Tense=Pres|VerbForm=Part
foreign	foreign	ADJ	Degree=Pos
occur	occur	VERB	VerbForm=Inf
probably	probably	ADV	_
stop	stop	NOUN	Number=Sing
stop	stop	VERB	VerbForm=Inf
*	*	PUNCT	_
card	card	NOUN	Number=Sing
democracy	democracy	NOUN	Number=Sing
Same	same	ADJ	Degree=Pos
peace	peace	NOUN	Number=Sing
learning	learn	VERB	VerbForm=Ger
patience	patience	NOUN	Number=Sing
12:30	12:30	NUM	NumType=Card
cooperation	cooperation	NOUN	Number=Sing
01	01	NUM	NumType=Card
pictures	picture	NOUN	Number=Plur
Congress	Congress	PROPN	Number=Sing
buses	bus	NOUN	Number=Plur
director	director	NOUN	Number=Sing
primary	primary	ADJ	Degree=Pos
THEY	they	PRON	Case=Nom|Number=Plur|Person=3|PronType=Prs
cultural	cultural	ADJ	Degree=Pos
There	there	PRON	_
guys	guy	NOUN	Number=Plur
dies	die	VERB	Mood=Ind|Number=Sing|Person=3|Tense=Pres|VerbForm=Fin
(	(	X	_
(	(	PUNCT	_
notes	note	NOUN	Number=Plur
employment	employment	NOUN	Number=Sing
20.000	20.000	NUM	NumType=Card
Leonardo	Leonardo	PROPN	Number=Sing
trash	trash	NOUN	Number=Sing
students	student	NOUN	Number=Plur
cap	cap	NOUN	Number=Sing
helicopters	helicopter	NOUN	Number=Plur
11/29/2000	11/29/2000	NUM	NumType=Card
relief	relief	NOUN	Number=Sing
surprised	surprised	ADJ	Degree=Pos
bite	bite	VERB	VerbForm=Inf
follows	follow	VERB	Mood=Ind|Number=Sing|Person=3|Tense=Pres|VerbForm=Fin
pool	pool	NOUN	Number=Sing
**	**	PUNCT	_
somewhere	somewhere	ADV	_
cute	cute	ADJ	Degree=Pos
her	she	PRON	Case=Acc|Gender=Fem|Number=Sing|Person=3|PronType=Prs
her	she	PRON	Gender=Fem|Number=Sing|Person=3|Poss=Yes|PronType=Prs
whole	whole	ADJ	Degree=Pos
husband	husband	NOUN	Number=Sing
maintain	maintain	VERB	VerbForm=Inf
perfectly	perfectly	ADV	_
charges	charge	NOUN	Number=Plur
stay	stay	VERB	VerbForm=Inf
stay	stay	NOUN	Number=Sing
stay	stay	VERB	Mood=Imp|VerbForm=Fin
Password	password	NOUN	Number=Sing
holds	hold	VERB	Mood=Ind|Number=Sing|Person=3|Tense=Pres|VerbForm=Fin
a	a	X	_
a	a	DET	Definite=Ind|PronType=Art
a	a	NOUN	Number=Sing
a	a	ADV	_
loss	loss	NOUN	Number=Sing
Robinson	Robinson	PROPN	Number=Sing
puppy	puppy	NOUN	Number=Sing
submitted	submit	VERB	Tense=Past|VerbForm=Part
session	session	NOUN	Number=Sing
PS	ps	NOUN	Number=Sing
***	***	PUNCT	_
Terrell	Terrell	PROPN	Number=Sing
participation	participation	NOUN	Number=Sing
youngest	youngest	ADJ	Degree=Sup
complete	complete	ADJ	Degree=Pos
customers	customer	NOUN	Number=Plur
The	the	DET	Definite=Def|PronType=Art
away	away	ADP	_
away	away	ADV	_
significant	significant	ADJ	Degree=Pos
single	single	ADJ	Degree=Pos
downtown	downtown	NOUN	Number=Sing
current	current	ADJ	Degree=Pos
Miramar	Miramar	PROPN	Number=Sing
trying	try	VERB	Tense=Pres|VerbForm=Part
trying	try	VERB	VerbForm=Ger
Friday	Friday	PROPN	Number=Sing
propose	propose	VERB	Mood=Ind|Tense=Pres|VerbForm=Fin
Essie	Essie	PROPN	Number=Sing
subsequent	subsequent	ADJ	Degree=Pos
being	being	NOUN	Number=Sing
being	be	AUX	VerbForm=Ger
background	background	NOUN	Number=Sing
belt	belt	NOUN	Number=Sing
Information	information	NOUN	Number=Sing
leads	lead	VERB	Mood=Ind|Number=Sing|Person=3|Tense=Pres|VerbForm=Fin
Agreement	agreement	NOUN	Number=Sing
perhaps	perhaps	ADV	_
quotes	quote	NOUN	Number=Plur
Agel	Agel	PROPN	Number=Sing
Leahy	Leahy	PROPN	Number=Sing
herself	herself	PRON	Case=Acc|Gender=Fem|Number=Sing|Person=3|PronType=Prs|Reflex=Yes
natural	natural	ADJ	Degree=Pos
â€”	-	PUNCT	_
love	love	VERB	Mood=Ind|Tense=Pres|VerbForm=Fin
love	love	NOUN	Number=Sing
love	love	VERB	VerbForm=Inf
closer	closer	ADJ	Degree=Cmp
reviews	review	NOUN	Number=Plur
throw	throw	VERB	VerbForm=Inf
visible	visible	ADJ	Degree=Pos
chickens	chicken	NOUN	Number=Plur
credit	credit	NOUN	Number=Sing
including	include	VERB	VerbForm=Ger
behalf	behalf	NOUN	Number=Sing
connections	connection	NOUN	Number=Plur
areas	area	NOUN	Number=Plur
In	in	ADP	_
owner	owner	NOUN	Number=Sing
founder	founder	NOUN	Number=Sing
Ferrous	Ferrous	PROPN	Number=Sing
planned	plan	VERB	Tense=Past|VerbForm=Part
minute	minute	NOUN	Number=Sing
offer	offer	NOUN	Number=Sing
offer	offer	VERB	Mood=Ind|Tense=Pres|VerbForm=Fin
offer	offer	VERB	VerbForm=Inf
Hyatt	Hyatt	PROPN	Number=Sing
allegedly	allegedly	ADV	_
bombings	bombing	NOUN	Number=Plur
obligation	obligation	NOUN	Number=Sing
HANO	HANO	PROPN	Number=Sing
Average	average	ADJ	Degree=Pos
Hussein	Hussein	PROPN	Number=Sing
air	air	NOUN	Number=Sing
Christmas	Christmas	PROPN	Number=Sing
view	view	VERB	VerbForm=Inf
view	view	NOUN	Number=Sing
straight	straight	ADJ	Degree=Pos
straight	straight	ADV	_
shop	shop	NOUN	Number=Sing
Amount	amount	NOUN	Number=Sing
wants	want	VERB	Mood=Ind|Number=Sing|Person=3|Tense=Pres|VerbForm=Fin
Mujahedeen	Mujahedeen	PROPN	Number=Sing
middle	middle	NOUN	Number=Sing
research	research	NOUN	Number=Sing
feedback	feedback	NOUN	Number=Sing
ISO	ISO	PROPN	Number=Sing
Anthony	Anthony	PROPN	Number=Sing
less	less	ADJ	Degree=Cmp
less	less	ADV	Degree=Cmp
fast	fast	ADJ	Degree=Pos
Corporate	corporate	ADJ	Degree=Pos
meeting	meet	VERB	VerbForm=Ger
meeting	meeting	NOUN	Number=Sing
animal	animal	NOUN	Number=Sing
services	service	NOUN	Number=Plur
Housing	Housing	PROPN	Number=Sing
goals	goal	NOUN	Number=Plur
International	International	PROPN	Number=Sing
number	number	NOUN	Number=Sing
)	)	X	_
)	)	PUNCT	_
and	and	CCONJ	_
and	and	X	_
and	a	DET	Typo=Yes
Art	Art	PROPN	Number=Sing
giving	give	VERB	VerbForm=Ger
giving	give	VERB	Tense=Pres|VerbForm=Part
differences	difference	NOUN	Number=Plur
question	question	NOUN	Number=Sing
demand	demand	NOUN	Number=Sing
changing	change	VERB	VerbForm=Ger
Nov.	Nov.	PROPN	Number=Sing
leading	lead	VERB	VerbForm=Ger
[	[	PUNCT	_
require	require	VERB	Mood=Ind|Tense=Pres|VerbForm=Fin
require	require	VERB	VerbForm=Inf
now	now	ADV	_
voted	vote	VERB	Mood=Ind|Tense=Past|VerbForm=Fin
cause	cause	SCONJ	_
cause	cause	VERB	VerbForm=Inf
cause	cause	NOUN	Number=Sing
Barclays	Barclays	PROPN	Number=Sing
hundreds	hundred	NOUN	Number=Plur
Because	because	SCONJ	_
paperwork	paperwork	NOUN	Number=Sing
lower	lower	ADJ	Degree=Cmp
contractor	contractor	NOUN	Number=Sing
story	story	NOUN	Number=Sing
attached	attach	VERB	Tense=Past|VerbForm=Part
attached	attach	VERB	Tense=Past|VerbForm=Part|Voice=Pass
YOU	you	PRON	Case=Acc|Person=2|PronType=Prs
YOU	you	PRON	Case=Nom|Person=2|PronType=Prs
systems	system	NOUN	Number=Plur
thought	think	VERB	Mood=Ind|Tense=Past|VerbForm=Fin
thought	thought	NOUN	Number=Sing
thought	think	VERB	Tense=Past|VerbForm=Part
watched	watch	VERB	Mood=Ind|Tense=Past|VerbForm=Fin
35	35	NUM	NumType=Card
run	run	VERB	Tense=Past|VerbForm=Part
run	run	VERB	VerbForm=Inf
run	run	NOUN	Number=Sing
elected	elect	VERB	Tense=Past|VerbForm=Part|Voice=Pass
conviction	conviction	NOUN	Number=Sing
clear	clear	ADJ	Degree=Pos
between	between	ADP	_
weekends	weekend	NOUN	Number=Plur
Philadelphia	Philadelphia	PROPN	Number=Sing
name	name	VERB	VerbForm=Inf
name	name	NOUN	Number=Sing
agreed	agree	VERB	Mood=Ind|Tense=Past|VerbForm=Fin
agreed	agree	VERB	Tense=Past|VerbForm=Part
delicious	delicious	ADJ	Degree=Pos
safer	safer	ADJ	Degree=Cmp
addresses	address	NOUN	Number=Plur
Israeli	israeli	ADJ	Degree=Pos
Colin	Colin	PROPN	Number=Sing
Al	Al	PROPN	Number=Sing
mother	mother	NOUN	Number=Sing
KSM	KSM	PROPN	Number=Sing
realized	realize	VERB	Mood=Ind|Tense=Past|VerbForm=Fin
four	four	NUM	NumType=Card
looked	look	VERB	Mood=Ind|Tense=Past|VerbForm=Fin
build	build	VERB	VerbForm=Inf
heart	heart	NOUN	Number=Sing
notch	notch	NOUN	Number=Sing
nails	nail	NOUN	Number=Plur
Analysis_0712	analysis_0712	X	_
Delhi	Delhi	PROPN	Number=Sing
seeking	seek	VERB	VerbForm=Ger
seeking	seek	VERB	Tense=Pres|VerbForm=Part
â€˜â€™	''	PUNCT	_
miss	miss	VERB	VerbForm=Inf
results	result	NOUN	Number=Plur
comparison	comparison	NOUN	Number=Sing
moved	move	VERB	Tense=Past|VerbForm=Part
moved	move	VERB	Mood=Ind|Tense=Past|VerbForm=Fin
winter	winter	NOUN	Number=Sing
Cafe	Cafe	PROPN	Number=Sing
Here	here	ADV	PronType=Dem
with	with	SCONJ	_
with	with	ADP	_
've	have	AUX	Mood=Ind|Tense=Pres|VerbForm=Fin
Abdul	Abdul	PROPN	Number=Sing
accordingly	accordingly	ADV	_
LOVE	love	VERB	Mood=Ind|Tense=Pres|VerbForm=Fin
to	to	PART	_
to	to	SCONJ	_
to	to	ADP	_
to	to	ADV	_
to	too	ADV	Typo=Yes
visa	visa	NOUN	Number=Sing
designer	designer	NOUN	Number=Sing
move	move	NOUN	Number=Sing
move	move	VERB	VerbForm=Inf
openly	openly	ADV	_
links	link	NOUN	Number=Plur
anybody	anybody	PRON	Number=Sing
series	series	NOUN	Number=Sing
ready	ready	ADJ	Degree=Pos
cheese	cheese	NOUN	Number=Sing
great	great	ADJ	Degree=Pos
resume	resume	NOUN	Number=Sing
sandwiches	sandwich	NOUN	Number=Plur
7:30	7:30	NUM	NumType=Card
replaced	replace	VERB	Tense=Past|VerbForm=Part
invoices	invoice	NOUN	Number=Plur
interview	interview	NOUN	Number=Sing
Client	client	NOUN	Number=Sing
relax	relax	VERB	VerbForm=Inf
ROW	row	NOUN	Number=Sing
camera	camera	NOUN	Number=Sing
AA	aa	NOUN	Number=Sing
signing	signing	NOUN	Number=Sing
Monotheism	Monotheism	PROPN	Number=Sing
sending	send	VERB	VerbForm=Ger
sending	send	VERB	Tense=Pres|VerbForm=Part
seemed	seem	VERB	Mood=Ind|Tense=Past|VerbForm=Fin
Vice	vice	NOUN	Number=Sing
WASTE	waste	NOUN	Number=Sing
Upon	upon	ADP	_
1995	1995	NUM	NumType=Card
West	west	ADJ	Degree=Pos
West	West	PROPN	Number=Sing
easier	easier	ADJ	Degree=Cmp
taste	taste	NOUN	Number=Sing
taste	taste	VERB	Mood=Ind|Tense=Pres|VerbForm=Fin
catch	catch	VERB	VerbForm=Inf
figure	figure	VERB	VerbForm=Inf
Powell	Powell	PROPN	Number=Sing
jump	jump	VERB	VerbForm=Inf
done	do	VERB	Tense=Past|VerbForm=Part
done	do	VERB	Tense=Past|VerbForm=Part|Voice=Pass
done	done	ADJ	Degree=Pos
Paris	Paris	PROPN	Number=Sing
Bondad	bondad	NOUN	Number=Sing
loan	loan	NOUN	Number=Sing
please	please	INTJ	_
Sue	Sue	PROPN	Number=Sing
King	King	PROPN	Number=Sing
stops	stop	VERB	Mood=Ind|Number=Sing|Person=3|Tense=Pres|VerbForm=Fin
Ken	Ken	PROPN	Number=Sing
r	be	AUX	Mood=Ind|Tense=Pres|VerbForm=Fin
rarely	rarely	ADV	_
track	track	NOUN	Number=Sing
track	track	VERB	VerbForm=Inf
soft	soft	ADJ	Degree=Pos
loving	loving	ADJ	Degree=Pos
Front	Front	PROPN	Number=Sing
28	28	NUM	NumType=Card
mouse	mouse	NOUN	Number=Sing
while	while	SCONJ	_
while	while	NOUN	Number=Sing
stream	stream	NOUN	Number=Sing
freedom	freedom	NOUN	Number=Sing
code	code	NOUN	Number=Sing
just	just	ADV	_
studying	study	VERB	VerbForm=Ger
cheek	cheek	NOUN	Number=Sing
vendors	vendor	NOUN	Number=Plur
Court	Court	PROPN	Number=Sing
tour	tour	NOUN	Number=Sing
creation	creation	NOUN	Number=Sing
de	de	PROPN	Number=Sing
establish	establish	VERB	VerbForm=Inf
road	road	NOUN	Number=Sing
none	none	NOUN	Number=Sing
talking	talk	VERB	Tense=Pres|VerbForm=Part
talking	talk	VERB	VerbForm=Ger
war	war	NOUN	Number=Sing
Moslem	moslem	ADJ	Degree=Pos
Never	never	ADV	_
extremist	extremist	NOUN	Number=Sing
makes	make	VERB	Mood=Ind|Number=Sing|Person=3|Tense=Pres|VerbForm=Fin
Immigration	Immigration	PROPN	Number=Sing
neck	neck	NOUN	Number=Sing
hospital	hospital	NOUN	Number=Sing
physical	physical	ADJ	Degree=Pos
title	title	NOUN	Number=Sing
books	book	NOUN	Number=Plur
Gonzales	Gonzales	PROPN	Number=Sing
1991	1991	NUM	NumType=Card
therefore	therefore	ADV	_
everywhere	everywhere	ADV	_
/	/	SYM	_
/	/	PUNCT	_
city	city	NOUN	Number=Sing
caused	cause	VERB	Tense=Past|VerbForm=Part
caused	cause	VERB	Mood=Ind|Tense=Past|VerbForm=Fin
up	up	ADV	_
up	up	ADP	_
up	up	NOUN	Number=Sing
Paragraph	paragraph	NOUN	Number=Sing
Sincerely	sincerely	ADV	_
stability	stability	NOUN	Number=Sing
NOTE	note	NOUN	Number=Sing
putting	put	VERB	Tense=Pres|VerbForm=Part
putting	put	VERB	VerbForm=Ger
DO	do	AUX	Mood=Imp|VerbForm=Fin
D.C.	D.C.	PROPN	Number=Sing
U.S.	U.S.	PROPN	Number=Sing
record	record	NOUN	Number=Sing
'm	be	AUX	Mood=Ind|Tense=Pres|VerbForm=Fin
pledged	pledge	VERB	Mood=Ind|Tense=Past|VerbForm=Fin
Ontario	Ontario	PROPN	Number=Sing
shortly	shortly	ADV	_
ordered	order	VERB	Mood=Ind|Tense=Past|VerbForm=Fin
ordered	order	VERB	Tense=Past|VerbForm=Part
impressed	impressed	ADJ	Degree=Pos
Yale	Yale	PROPN	Number=Sing
Bangs	Bangs	PROPN	Number=Sing
faith	faith	NOUN	Number=Sing
reception	reception	NOUN	Number=Sing
son	son	NOUN	Number=Sing
Kennedy	Kennedy	PROPN	Number=Sing
involved	involved	ADJ	Degree=Pos
involved	involve	VERB	Tense=Past|VerbForm=Part
Email	email	NOUN	Number=Sing
develop	develop	VERB	VerbForm=Inf
old	old	ADJ	Degree=Pos
Diego	Diego	PROPN	Number=Sing
says	say	VERB	Mood=Ind|Number=Sing|Person=3|Tense=Pres|VerbForm=Fin
nations	nation	NOUN	Number=Plur
York	York	PROPN	Number=Sing
â€™â€™	''	PUNCT	_
BEST	best	ADJ	Degree=Sup
rate	rate	NOUN	Number=Sing
knowledgeable	knowledgeable	ADJ	Degree=Pos
capital	capital	NOUN	Number=Sing
wearing	wear	VERB	VerbForm=Ger
generation	generation	NOUN	Number=Sing
accident	accident	NOUN	Number=Sing
other	other	ADJ	Degree=Pos
spiritual	spiritual	ADJ	Degree=Pos
pull	pull	VERB	VerbForm=Inf
notify	notify	VERB	Mood=Imp|VerbForm=Fin
blue	blue	ADJ	Degree=Pos
Gregg	Gregg	PROPN	Number=Sing
relaxed	relaxed	ADJ	Degree=Pos
search	search	NOUN	Number=Sing
search	search	VERB	VerbForm=Inf
tanks	tank	NOUN	Number=Plur
includes	include	VERB	Mood=Ind|Number=Sing|Person=3|Tense=Pres|VerbForm=Fin
sooner	sooner	ADV	Degree=Cmp
cleaned	clean	VERB	Tense=Past|VerbForm=Part
provided	provide	VERB	Tense=Past|VerbForm=Part
provided	provide	VERB	Tense=Past|VerbForm=Part|Voice=Pass
provided	provide	VERB	Mood=Ind|Tense=Past|VerbForm=Fin
drop	drop	VERB	VerbForm=Inf
active	active	ADJ	Degree=Pos
music	music	NOUN	Number=Sing
identity	identity	NOUN	Number=Sing
Sri	Sri	PROPN	Number=Sing
After	after	SCONJ	_
After	after	ADP	_
continue	continue	VERB	Mood=Ind|Tense=Pres|VerbForm=Fin
continue	continue	VERB	VerbForm=Inf
Wilson	Wilson	PROPN	Number=Sing
feathers	feather	NOUN	Number=Plur
chance	chance	NOUN	Number=Sing
effects	effect	NOUN	Number=Plur
shows	show	VERB	Mood=Ind|Number=Sing|Person=3|Tense=Pres|VerbForm=Fin
shows	show	NOUN	Number=Plur
orders	order	NOUN	Number=Plur
cup	cup	NOUN	Number=Sing
formal	formal	ADJ	Degree=Pos
numerous	numerous	ADJ	Degree=Pos
Fortier	Fortier	PROPN	Number=Sing
8	8	NUM	NumType=Card
gym	gym	NOUN	Number=Sing
whatever	whatever	PRON	PronType=Int
whatever	whatever	DET	PronType=Int
read	read	VERB	VerbForm=Inf
read	read	VERB	Mood=Ind|Tense=Past|VerbForm=Fin
read	read	VERB	Mood=Imp|VerbForm=Fin
read	read	VERB	Tense=Past|VerbForm=Part
read	read	VERB	Mood=Ind|Tense=Pres|VerbForm=Fin
1970	1970	NUM	NumType=Card
30th	30th	NOUN	Number=Sing
months	month	NOUN	Number=Plur
box	box	NOUN	Number=Sing
leave	leave	VERB	Mood=Imp|VerbForm=Fin
leave	leave	VERB	Mood=Ind|Tense=Pres|VerbForm=Fin
leave	leave	VERB	VerbForm=Inf
+	+	SYM	_
helpful	helpful	ADJ	Degree=Pos
fence	fence	NOUN	Number=Sing
lives	life	NOUN	Number=Plur
appreciate	appreciate	VERB	Mood=Ind|Tense=Pres|VerbForm=Fin
appreciate	appreciate	VERB	VerbForm=Inf
manual	manual	ADJ	Degree=Pos
Association	Association	PROPN	Number=Sing
day	day	NOUN	Number=Sing
Much	much	ADJ	Degree=Pos
served	serve	VERB	Tense=Past|VerbForm=Part|Voice=Pass
served	serve	VERB	Tense=Past|VerbForm=Part
served	serve	VERB	Mood=Ind|Tense=Past|VerbForm=Fin
race	race	NOUN	Number=Sing
crappy	crappy	ADJ	Degree=Pos
smoke	smoke	NOUN	Number=Sing
urine	urine	NOUN	Number=Sing
commission	commission	NOUN	Number=Sing
2001	2001	NUM	NumType=Card
mama	mama	NOUN	Number=Sing
Stephanie	Stephanie	PROPN	Number=Sing
THEN	then	ADV	PronType=Dem
absolute	absolute	ADJ	Degree=Pos
Mike	Mike	PROPN	Number=Sing
Britain	Britain	PROPN	Number=Sing
generally	generally	ADV	_
individuals	individual	NOUN	Number=Plur
vulnerable	vulnerable	ADJ	Degree=Pos
proud	proud	ADJ	Degree=Pos
equipment	equipment	NOUN	Number=Sing
satanism	satanism	PROPN	Number=Sing
accounts	account	NOUN	Number=Plur
20	20	NUM	NumType=Card
people	people	NOUN	Number=Plur
safety	safety	NOUN	Number=Sing
Agency	Agency	PROPN	Number=Sing
ride	ride	NOUN	Number=Sing
so	so	ADV	_
so	so	SCONJ	_
lighting	lighting	NOUN	Number=Sing
Kandahar	Kandahar	PROPN	Number=Sing
Securities	Securities	PROPN	Number=Plur
nâ€™t	not	PART	_
ammunition	ammunition	NOUN	Number=Sing
stopped	stop	VERB	Tense=Past|VerbForm=Part|Voice=Pass
stopped	stop	VERB	Mood=Ind|Tense=Past|VerbForm=Fin
launch	launch	VERB	VerbForm=Inf
launch	launch	NOUN	Number=Sing
arrived	arrive	VERB	Mood=Ind|Tense=Past|VerbForm=Fin
lots	lot	NOUN	Number=Plur
Karim	Karim	PROPN	Number=Sing
elements	element	NOUN	Number=Plur
certainly	certainly	ADV	_
airlines	airline	NOUN	Number=Plur
fully	fully	ADV	_
gain	gain	VERB	VerbForm=Inf
added	add	VERB	Tense=Past|VerbForm=Part|Voice=Pass
added	add	VERB	Tense=Past|VerbForm=Part
added	add	VERB	Mood=Ind|Tense=Past|VerbForm=Fin
providers	provider	NOUN	Number=Plur
client	client	NOUN	Number=Sing
sat	sit	VERB	Mood=Ind|Tense=Past|VerbForm=Fin
shocked	shocked	ADJ	Degree=Pos
Even	even	ADV	_
PLEASE	please	INTJ	_
Disney	Disney	PROPN	Number=Sing
work	work	NOUN	Number=Sing
work	work	VERB	Mood=Ind|Tense=Pres|VerbForm=Fin
work	work	VERB	VerbForm=Inf
Read	read	VERB	Mood=Imp|VerbForm=Fin
procedure	procedure	NOUN	Number=Sing
We	we	PRON	Case=Nom|Number=Plur|Person=1|PronType=Prs
Network	Network	PROPN	Number=Sing
muscle	muscle	NOUN	Number=Sing
NEVER	never	ADV	_
guerrillas	guerrilla	NOUN	Number=Plur
Winter	Winter	PROPN	Number=Sing
Afghanistan	Afghanistan	PROPN	Number=Sing
Iranian	iranian	ADJ	Degree=Pos
word	word	NOUN	Number=Sing
Parenteau	Parenteau	PROPN	Number=Sing
animals	animal	NOUN	Number=Plur
Go	go	VERB	Mood=Imp|VerbForm=Fin
shall	shall	AUX	VerbForm=Fin
phase	phase	NOUN	Number=Sing
Shanna	Shanna	PROPN	Number=Sing
bomb	bomb	NOUN	Number=Sing
all	all	DET	_
all	all	ADV	_
themselves	themselves	PRON	Case=Acc|Number=Plur|Person=3|PronType=Prs|Reflex=Yes
themselves	themselves	PRON	Number=Plur|Person=3|PronType=Prs
Nobody	nobody	PRON	Number=Sing
engine	engine	NOUN	Number=Sing
documents	document	NOUN	Number=Plur
6	6	NUM	NumType=Card
D	D	PROPN	Number=Sing
D	d	NOUN	Number=Sing
flowing	flow	VERB	VerbForm=Ger
taxi	taxi	NOUN	Number=Sing
around	around	ADP	_
around	around	ADV	_
birds	bird	NOUN	Number=Plur
fly	fly	VERB	VerbForm=Inf
Dr.	Dr.	PROPN	Number=Sing
Therefore	therefore	ADV	_
short	short	ADJ	Degree=Pos
Gaza	Gaza	PROPN	Number=Sing
Had	have	VERB	Mood=Ind|Tense=Past|VerbForm=Fin
grip	grip	NOUN	Number=Sing
speak	speak	VERB	Mood=Ind|Tense=Pres|VerbForm=Fin
speak	speak	VERB	VerbForm=Inf
degrees	degree	NOUN	Number=Plur
website	website	NOUN	Number=Sing
mess	mess	NOUN	Number=Sing
global	global	ADJ	Degree=Pos
lease	lease	NOUN	Number=Sing
Egyptian	egyptian	ADJ	Degree=Pos
Egyptian	Egyptian	PROPN	Number=Sing
cards	card	NOUN	Number=Plur
plane	plane	NOUN	Number=Sing
discovered	discover	VERB	Mood=Ind|Tense=Past|VerbForm=Fin
homeland	homeland	NOUN	Number=Sing
's	's	PRON	Case=Acc|Number=Plur|Person=1|PronType=Prs
's	be	AUX	Mood=Ind|Number=Sing|Person=3|Tense=Pres|VerbForm=Fin
's	be	VERB	Mood=Ind|Number=Sing|Person=3|Tense=Pres|VerbForm=Fin
's	's	PART	_
visiting	visit	VERB	VerbForm=Ger
GOODWYN	GOODWYN	PROPN	Number=Sing
reportedly	reportedly	ADV	_
answers	answer	NOUN	Number=Plur
19	19	NUM	NumType=Card
Laden	Laden	PROPN	Number=Sing
online	online	ADJ	Degree=Pos
online	online	ADV	_
mad	mad	ADJ	Degree=Pos
Very	very	ADV	_
pilot	pilot	NOUN	Number=Sing
Finally	finally	ADV	_
you	you	PRON	Case=Acc|Person=2|PronType=Prs
you	you	PRON	Case=Nom|Person=2|PronType=Prs
you	you	PRON	_
investment	investment	NOUN	Number=Sing
sites	site	NOUN	Number=Plur
liked	like	VERB	Mood=Ind|Tense=Past|VerbForm=Fin
prior	prior	ADJ	Degree=Pos
delivery	delivery	NOUN	Number=Sing
quickly	quickly	ADV	_
bag	bag	NOUN	Number=Sing
having	have	VERB	Tense=Pres|VerbForm=Part
having	have	VERB	VerbForm=Ger
having	have	AUX	VerbForm=Ger
western	western	ADJ	Degree=Pos
What	what	DET	PronType=Int
What	what	PRON	PronType=Int
admitted	admit	VERB	Mood=Ind|Tense=Past|VerbForm=Fin
Tuesday	Tuesday	PROPN	Number=Sing
Medical	Medical	PROPN	Number=Sing
Regards	regards	NOUN	Number=Plur
Yellowstone	Yellowstone	PROPN	Number=Sing
Question	question	NOUN	Number=Sing
sound	sound	NOUN	Number=Sing
sound	sound	VERB	VerbForm=Inf
Number	number	NOUN	Number=Sing
on	on	ADP	_
on	on	ADV	_
on	on	SCONJ	_
37	37	NUM	NumType=Card
federal	federal	ADJ	Degree=Pos
resources	resource	NOUN	Number=Plur
fool	fool	VERB	VerbForm=Inf
national	national	ADJ	Degree=Pos
appointment	appointment	NOUN	Number=Sing
help	help	VERB	VerbForm=Inf
help	help	VERB	Mood=Imp|VerbForm=Fin
help	help	NOUN	Number=Sing
slightly	slightly	ADV	_
need	need	VERB	VerbForm=Inf
need	need	VERB	Mood=Ind|Tense=Pres|VerbForm=Fin
need	need	NOUN	Number=Sing
showed	show	VERB	Mood=Ind|Tense=Past|VerbForm=Fin
needed	need	VERB	Mood=Ind|Tense=Past|VerbForm=Fin
needed	need	VERB	Tense=Past|VerbForm=Part
news	news	NOUN	Number=Sing
bill	bill	NOUN	Number=Sing
Alan	Alan	PROPN	Number=Sing
cold	cold	ADJ	Degree=Pos
capability	capability	NOUN	Number=Sing
foods	food	NOUN	Number=Plur
solid	solid	ADJ	Degree=Pos
yesterday	yesterday	NOUN	Number=Sing
sausages	sausage	NOUN	Number=Plur
assistant	assistant	NOUN	Number=Sing
different	different	ADJ	Degree=Pos
Quality	quality	NOUN	Number=Sing
Sorry	sorry	ADJ	Degree=Pos
representative	representative	NOUN	Number=Sing
Senior	senior	ADJ	Degree=Pos
invoice	invoice	NOUN	Number=Sing
Fiji	Fiji	PROPN	Number=Sing
compassionate	compassionate	ADJ	Degree=Pos
Tablet	Tablet	PROPN	Number=Sing
His	he	PRON	Gender=Masc|Number=Sing|Person=3|Poss=Yes|PronType=Prs
Under	under	ADP	_
rich	rich	ADJ	Degree=Pos
occurred	occur	VERB	Mood=Ind|Tense=Past|VerbForm=Fin
dated	date	VERB	Tense=Past|VerbForm=Part
Pervez	Pervez	PROPN	Number=Sing
ignore	ignore	VERB	VerbForm=Inf
hamster	hamster	NOUN	Number=Sing
Earl	Earl	PROPN	Number=Sing
missile	missile	NOUN	Number=Sing
x	x	NOUN	Number=Sing
x	x	SYM	_
Sussex	sussex	NOUN	Number=Sing
favorite	favorite	ADJ	Degree=Pos
favorite	favorite	NOUN	Number=Sing
adjusted	adjust	VERB	Tense=Past|VerbForm=Part|Voice=Pass
complaints	complaint	NOUN	Number=Plur
injury	injury	NOUN	Number=Sing
millions	million	NOUN	Number=Plur
State	state	NOUN	Number=Sing
State	State	PROPN	Number=Sing
marriage	marriage	NOUN	Number=Sing
unlikely	unlikely	ADJ	Degree=Pos
MHC	MHC	PROPN	Number=Sing
District	District	PROPN	Number=Sing
policy	policy	NOUN	Number=Sing
Sitara	Sitara	PROPN	Number=Sing
aboard	aboard	ADV	_
budget	budget	NOUN	Number=Sing
lies	lie	NOUN	Number=Plur
lies	lie	VERB	Mood=Ind|Number=Sing|Person=3|Tense=Pres|VerbForm=Fin
safe	safe	ADJ	Degree=Pos
came	come	VERB	Mood=Ind|Tense=Past|VerbForm=Fin
USB	usb	NOUN	Number=Sing
net	net	NOUN	Number=Sing
21	21	NUM	NumType=Card
chocolate	chocolate	NOUN	Number=Sing
suggestions	suggestion	NOUN	Number=Plur
AS400	as400	NOUN	Number=Sing
instead	instead	ADV	_
etc.	etc.	X	_
providing	provide	VERB	VerbForm=Ger
colleagues	colleague	NOUN	Number=Plur
brain	brain	NOUN	Number=Sing
experience	experience	NOUN	Number=Sing
pub	pub	NOUN	Number=Sing
enforcement	enforcement	NOUN	Number=Sing
murder	murder	NOUN	Number=Sing
deeply	deeply	ADV	_
spring	spring	NOUN	Number=Sing
see	see	VERB	Mood=Ind|Tense=Pres|VerbForm=Fin
see	see	VERB	Mood=Imp|VerbForm=Fin
see	see	VERB	VerbForm=Inf
guards	guard	NOUN	Number=Plur
David	David	PROPN	Number=Sing
Irish	irish	ADJ	Degree=Pos
experiences	experience	NOUN	Number=Plur
copy	copy	NOUN	Number=Sing
copy	copy	VERB	VerbForm=Inf
My	my	PRON	Number=Sing|Person=1|Poss=Yes|PronType=Prs
route	route	NOUN	Number=Sing
Mariner	Mariner	PROPN	Number=Sing
Jordan	Jordan	PROPN	Number=Sing
forum	forum	NOUN	Number=Sing
Rice	Rice	PROPN	Number=Sing
suspect	suspect	NOUN	Number=Sing
assist	assist	VERB	VerbForm=Inf
MORE	more	ADJ	Degree=Cmp
Clinton	Clinton	PROPN	Number=Sing
Clean	clean	ADJ	Degree=Pos
opposed	oppose	VERB	Tense=Past|VerbForm=Part
winning	win	VERB	VerbForm=Ger
btw	btw	ADV	_
puts	put	NOUN	Number=Plur
puts	put	VERB	Mood=Ind|Number=Sing|Person=3|Tense=Pres|VerbForm=Fin
Imagine	imagine	VERB	Mood=Imp|VerbForm=Fin
graduate	graduate	NOUN	Number=Sing
Middle	Middle	PROPN	Number=Sing
.	.	PUNCT	_
Why	why	ADV	PronType=Int
murders	murder	NOUN	Number=Plur
related	related	ADJ	Degree=Pos
bedroom	bedroom	NOUN	Number=Sing
concerns	concern	NOUN	Number=Plur
dangerous	dangerous	ADJ	Degree=Pos
bid	bid	NOUN	Number=Sing
litter	litter	NOUN	Number=Sing
maybe	maybe	ADV	_
dance	dance	NOUN	Number=Sing
officials	official	NOUN	Number=Plur
economy	economy	NOUN	Number=Sing
Expect	expect	VERB	Mood=Imp|VerbForm=Fin
may	may	AUX	VerbForm=Fin
window	window	NOUN	Number=Sing
correct	correct	ADJ	Degree=Pos
clothing	clothing	NOUN	Number=Sing
fight	fight	NOUN	Number=Sing
fight	fight	VERB	Mood=Ind|Tense=Pres|VerbForm=Fin
fight	fight	VERB	VerbForm=Inf
civilized	civilized	ADJ	Degree=Pos
item	item	NOUN	Number=Sing
San	San	PROPN	Number=Sing
tribe	tribe	NOUN	Number=Sing
team	team	NOUN	Number=Sing
Limerick	Limerick	PROPN	Number=Sing
11:00	11:00	NUM	NumType=Card
hotels	hotel	NOUN	Number=Plur
surrounding	surround	VERB	VerbForm=Ger
Meanwhile	meanwhile	ADV	_
RAPHAEL	RAPHAEL	PROPN	Number=Sing
properties	property	NOUN	Number=Plur
sauce	sauce	NOUN	Number=Sing
listed	list	VERB	Tense=Past|VerbForm=Part
anyways	anyways	ADV	_
Sao	Sao	PROPN	Number=Sing
negotiated	negotiate	VERB	Tense=Past|VerbForm=Part
dealing	deal	VERB	VerbForm=Ger
positions	position	NOUN	Number=Plur
killed	kill	VERB	Mood=Ind|Tense=Past|VerbForm=Fin
killed	kill	VERB	Tense=Past|VerbForm=Part|Voice=Pass
killed	kill	VERB	Tense=Past|VerbForm=Part
Pakistani	pakistani	ADJ	Degree=Pos
extreme	extreme	ADJ	Degree=Pos
literally	literally	ADV	_
something	something	PRON	Number=Sing
Central	Central	PROPN	Number=Sing
assume	assume	VERB	Mood=Ind|Tense=Pres|VerbForm=Fin
assume	assume	VERB	VerbForm=Inf
greater	greater	ADJ	Degree=Cmp
greatest	greatest	ADJ	Degree=Sup
started	start	VERB	Mood=Ind|Tense=Past|VerbForm=Fin
started	start	VERB	Tense=Past|VerbForm=Part
04/30/2001	04/30/2001	NUM	NumType=Card
sector	sector	NOUN	Number=Sing
meal	meal	NOUN	Number=Sing
ten	ten	NUM	NumType=Card
SF	SF	PROPN	Number=Sing
February	February	PROPN	Number=Sing
others	other	NOUN	Number=Plur
opportunities	opportunity	NOUN	Number=Plur
hotel	hotel	NOUN	Number=Sing
trust	trust	NOUN	Number=Sing
trust	trust	VERB	VerbForm=Inf
trust	trust	VERB	Mood=Ind|Tense=Pres|VerbForm=Fin
Canada	Canada	PROPN	Number=Sing
noted	note	VERB	Mood=Ind|Tense=Past|VerbForm=Fin
nest	nest	NOUN	Number=Sing
Usually	usually	ADV	_
X	x	NOUN	Number=Sing
Smith	Smith	PROPN	Number=Sing
Then	then	ADV	PronType=Dem
Wood	Wood	PROPN	Number=Sing
teachers	teacher	NOUN	Number=Plur
Africa	Africa	PROPN	Number=Sing
estate	estate	NOUN	Number=Sing
size	size	NOUN	Number=Sing
Nothing	nothing	PRON	Number=Sing
an	a	DET	Definite=Ind|PronType=Art
legal	legal	ADJ	Degree=Pos
Shackleton	Shackleton	PROPN	Number=Sing
source	source	NOUN	Number=Sing
Please	please	INTJ	_
hence	hence	ADV	_
worth	worth	ADJ	Degree=Pos
ISS	ISS	PROPN	Number=Sing
Those	those	DET	Number=Plur|PronType=Dem
Those	those	PRON	Number=Plur|PronType=Dem
sun	sun	NOUN	Number=Sing
groups	group	NOUN	Number=Plur
seek	seek	VERB	VerbForm=Inf
Sara	Sara	PROPN	Number=Sing
leash	leash	NOUN	Number=Sing
manager	manager	NOUN	Number=Sing
News	news	NOUN	Number=Sing
News	News	PROPN	Number=Sing
&	&	CCONJ	_
2010	2010	NUM	NumType=Card
begin	begin	VERB	VerbForm=Inf
begin	begin	VERB	Mood=Ind|Tense=Pres|VerbForm=Fin
murderers	murderer	NOUN	Number=Plur
accepted	accept	VERB	Mood=Ind|Tense=Past|VerbForm=Fin
accepted	accept	VERB	Tense=Past|VerbForm=Part|Voice=Pass
lap	lap	NOUN	Number=Sing
Islamabad	Islamabad	PROPN	Number=Sing
(:	(:	SYM	_
high	high	ADJ	Degree=Pos
high	high	ADV	Degree=Pos
high	high	NOUN	Number=Sing
was	be	VERB	Mood=Ind|Number=Sing|Person=3|Tense=Past|VerbForm=Fin
was	be	AUX	Mood=Ind|Number=Sing|Person=1|Tense=Past|VerbForm=Fin
was	be	VERB	Mood=Ind|Number=Sing|Person=1|Tense=Past|VerbForm=Fin
was	be	AUX	Mood=Ind|Number=Sing|Person=3|Tense=Past|VerbForm=Fin
was	be	VERB	Mood=Ind|Number=Sing|Tense=Past|VerbForm=Fin
wife	wife	NOUN	Number=Sing
scenario	scenario	NOUN	Number=Sing
notification	notification	NOUN	Number=Sing
mine	mine	PRON	_
Houston	Houston	PROPN	Number=Sing
Elena	Elena	PROPN	Number=Sing
star	star	NOUN	Number=Sing
Posada	Posada	PROPN	Number=Sing
disability	disability	NOUN	Number=Sing
lunch	lunch	NOUN	Number=Sing
Unless	unless	SCONJ	_
Google	Google	PROPN	Number=Sing
rid	rid	ADJ	Degree=Pos
IF	if	SCONJ	_
requiring	require	VERB	VerbForm=Ger
plaster	plaster	NOUN	Number=Sing
receiving	receive	VERB	VerbForm=Ger
irish	irish	ADJ	Degree=Pos
Any	any	DET	_
coordinator	coordinator	NOUN	Number=Sing
release	release	VERB	VerbForm=Inf
release	release	NOUN	Number=Sing
Access	access	X	_
Application	application	NOUN	Number=Sing
some	some	DET	_
ended	end	VERB	Mood=Ind|Tense=Past|VerbForm=Fin
ALL	all	DET	_
dramatic	dramatic	ADJ	Degree=Pos
photo	photo	NOUN	Number=Sing
alternatives	alternative	NOUN	Number=Plur
aid	aid	NOUN	Number=Sing
purposes	purpose	NOUN	Number=Plur
land	land	NOUN	Number=Sing
phones	phone	NOUN	Number=Plur
movies	movie	NOUN	Number=Plur
Rumsfeld	Rumsfeld	PROPN	Number=Sing
12	12	NUM	NumType=Card
Ames	Ames	PROPN	Number=Sing
Firefox	Firefox	PROPN	Number=Sing
mutual	mutual	ADJ	Degree=Pos
one	one	PRON	_
one	one	NUM	NumType=Card
one	one	NOUN	Number=Sing
plot	plot	NOUN	Number=Sing
Arafat	Arafat	PROPN	Number=Sing
dwarf	dwarf	ADJ	Degree=Pos
Jeffs	Jeffs	PROPN	Number=Sing
light	light	NOUN	Number=Sing
light	light	ADJ	Degree=Pos
decade	decade	NOUN	Number=Sing
waste	waste	VERB	VerbForm=Inf
waste	waste	VERB	Mood=Imp|VerbForm=Fin
waste	waste	NOUN	Number=Sing
fish	fish	NOUN	Number=Plur
fish	fish	NOUN	Number=Sing
blind	blind	ADJ	Degree=Pos
must	must	AUX	VerbForm=Fin
held	hold	VERB	Mood=Ind|Tense=Past|VerbForm=Fin
held	hold	VERB	Tense=Past|VerbForm=Part
held	hold	VERB	Tense=Past|VerbForm=Part|Voice=Pass
Anderson	Anderson	PROPN	Number=Sing
independent	independent	ADJ	Degree=Pos
buy	buy	VERB	Mood=Ind|Tense=Pres|VerbForm=Fin
buy	buy	VERB	Mood=Imp|VerbForm=Fin
buy	buy	VERB	VerbForm=Inf
latter	latter	ADJ	Degree=Pos
pleasure	pleasure	NOUN	Number=Sing
Yazid	Yazid	PROPN	Number=Sing
bunch	bunch	NOUN	Number=Sing
battle	battle	NOUN	Number=Sing
located	locate	VERB	Tense=Past|VerbForm=Part|Voice=Pass
located	locate	VERB	Tense=Past|VerbForm=Part
airport	airport	NOUN	Number=Sing
its	its	PRON	Gender=Neut|Number=Sing|Person=3|Poss=Yes|PronType=Prs
Gas	gas	NOUN	Number=Sing
Gas	Gas	PROPN	Number=Sing
Try	try	VERB	Mood=Imp|VerbForm=Fin
wonderful	wonderful	ADJ	Degree=Pos
Zawahiri	Zawahiri	PROPN	Number=Sing
sea	sea	NOUN	Number=Sing
addition	addition	NOUN	Number=Sing
Energy	Energy	PROPN	Number=Sing
With	with	SCONJ	_
With	with	ADP	_
roll	roll	NOUN	Number=Sing
signature	signature	NOUN	Number=Sing
Hey	hey	INTJ	_
currency	currency	NOUN	Number=Sing
transactions	transaction	NOUN	Number=Plur
`s	be	AUX	Mood=Ind|Number=Sing|Person=3|Tense=Pres|VerbForm=Fin
K	K	PROPN	Number=Sing
K	k	NUM	NumType=Card
CPA	CPA	PROPN	Number=Sing
Feb	Feb	PROPN	Number=Sing
tend	tend	VERB	Mood=Ind|Tense=Pres|VerbForm=Fin
golden	golden	ADJ	Degree=Pos
spot	spot	NOUN	Number=Sing
Bin	Bin	PROPN	Number=Sing
attachment	attachment	NOUN	Number=Sing
hold	hold	VERB	VerbForm=Inf
Cargill	Cargill	PROPN	Number=Sing
generators	generator	NOUN	Number=Plur
checking	check	VERB	VerbForm=Ger
checking	check	VERB	Tense=Pres|VerbForm=Part
pork	pork	NOUN	Number=Sing
NO	no	DET	_
NO	no	INTJ	_
rat	rat	NOUN	Number=Sing
pleasant	pleasant	ADJ	Degree=Pos
Declaration	declaration	NOUN	Number=Sing
every	every	DET	_
Germany	Germany	PROPN	Number=Sing
wan	want	VERB	Abbr=Yes|Mood=Ind|Tense=Pres|VerbForm=Fin
them	they	PRON	Case=Acc|Number=Plur|Person=3|PronType=Prs
soon	soon	ADV	Degree=Pos
very	very	ADJ	Degree=Pos
very	very	ADV	_
nice	nice	ADJ	Degree=Pos
ca	can	AUX	VerbForm=Fin
males	male	NOUN	Number=Plur
kidney	kidney	NOUN	Number=Sing
collective	collective	ADJ	Degree=Pos
AWAY	away	ADV	_
Dan	Dan	PROPN	Number=Sing
called	call	VERB	Tense=Past|VerbForm=Part|Voice=Pass
called	call	VERB	Tense=Past|VerbForm=Part
called	call	VERB	Mood=Ind|Tense=Past|VerbForm=Fin
Richard	Richard	PROPN	Number=Sing
ASAP	asap	ADV	_
Blue	Blue	PROPN	Number=Sing
competition	competition	NOUN	Number=Sing
Duke	Duke	PROPN	Number=Sing
Mohammed	Mohammed	PROPN	Number=Sing
drinking	drink	VERB	VerbForm=Ger
drinking	drink	VERB	Tense=Pres|VerbForm=Part
supposed	suppose	VERB	Tense=Past|VerbForm=Part
buying	buy	VERB	VerbForm=Ger
allies	ally	NOUN	Number=Plur
than	than	SCONJ	_
than	than	ADP	_
age	age	NOUN	Number=Sing
Commission	Commission	PROPN	Number=Sing
Commission	commission	NOUN	Number=Sing
confirm	confirm	VERB	VerbForm=Inf
Tom	Tom	PROPN	Number=Sing
secure	secure	VERB	VerbForm=Inf
secure	secure	ADJ	Degree=Pos
Cheap	cheap	ADJ	Degree=Pos
bulb	bulb	NOUN	Number=Sing
before	before	ADV	_
before	before	ADP	_
before	before	SCONJ	_
refund	refund	NOUN	Number=Sing
ships	ship	NOUN	Number=Plur
hide	hide	VERB	VerbForm=Inf
boy	boy	NOUN	Number=Sing
Monday	Monday	PROPN	Number=Sing
big	big	ADJ	Degree=Pos
saving	save	VERB	VerbForm=Ger
flowers	flower	NOUN	Number=Plur
50	50	NUM	NumType=Card
arrested	arrest	VERB	Tense=Past|VerbForm=Part|Voice=Pass
Ruy	Ruy	PROPN	Number=Sing
Halal	halal	ADJ	Degree=Pos
sports	sport	NOUN	Number=Plur
worst	worst	ADJ	Degree=Sup
central	central	ADJ	Degree=Pos
surprisingly	surprisingly	ADV	_
warranty	warranty	NOUN	Number=Sing
Khalid	Khalid	PROPN	Number=Sing
were	be	VERB	Mood=Ind|Tense=Past|VerbForm=Fin
were	be	AUX	Mood=Ind|Tense=Past|VerbForm=Fin
chances	chance	NOUN	Number=Plur
issues	issue	NOUN	Number=Plur
estimate	estimate	NOUN	Number=Sing
Spanish	spanish	ADJ	Degree=Pos
'll	will	AUX	VerbForm=Fin
prices	price	NOUN	Number=Plur
call	call	NOUN	Number=Sing
call	call	VERB	VerbForm=Inf
call	call	VERB	Mood=Imp|VerbForm=Fin
call	call	VERB	Mood=Ind|Tense=Pres|VerbForm=Fin
defense	defense	NOUN	Number=Sing
Caribbean	Caribbean	PROPN	Number=Sing
fixed	fix	VERB	Tense=Past|VerbForm=Part
fixed	fix	VERB	Mood=Ind|Tense=Past|VerbForm=Fin
want	want	VERB	VerbForm=Inf
want	want	VERB	Mood=Ind|Tense=Pres|VerbForm=Fin
center	center	NOUN	Number=Sing
when	when	ADV	PronType=Rel
when	when	ADV	PronType=Int
outer	outer	ADJ	Degree=Pos
opinion	opinion	NOUN	Number=Sing
lyrics	lyric	NOUN	Number=Plur
EVER	ever	ADV	_
direct	direct	ADJ	Degree=Pos
problems	problem	NOUN	Number=Plur
Yoko	Yoko	PROPN	Number=Sing
becoming	become	VERB	VerbForm=Ger
Again	again	ADV	_
agent	agent	NOUN	Number=Sing
Despite	despite	ADP	_
direction	direction	NOUN	Number=Sing
minister	minister	NOUN	Number=Sing
lasted	last	VERB	Mood=Ind|Tense=Past|VerbForm=Fin
apartment	apartment	NOUN	Number=Sing
Tana	Tana	PROPN	Number=Sing
07/17/2000	07/17/2000	NUM	NumType=Card
Period	period	NOUN	Number=Sing
throughout	throughout	ADP	_
difficult	difficult	ADJ	Degree=Pos
missing	missing	ADJ	Degree=Pos
missing	miss	VERB	Tense=Pres|VerbForm=Part
nights	night	NOUN	Number=Plur
gender	gender	NOUN	Number=Sing
cases	case	NOUN	Number=Plur
wow	wow	INTJ	_
test	test	VERB	VerbForm=Inf
test	test	NOUN	Number=Sing
1,200	1,200	NUM	NumType=Card
glass	glass	NOUN	Number=Sing
adjustments	adjustment	NOUN	Number=Plur
EPM	epm	NOUN	Number=Sing
well	well	ADJ	Degree=Pos
well	well	ADV	Degree=Pos
well	well	INTJ	_
"	"	PUNCT	_
regarding	regard	VERB	VerbForm=Ger
miles	mile	NOUN	Number=Plur
days	day	NOUN	Number=Plur
Date	date	NOUN	Number=Sing
since	since	ADP	_
since	since	ADV	_
since	since	SCONJ	_
debt	debt	NOUN	Number=Sing
auto	auto	NOUN	Number=Sing
killing	kill	VERB	VerbForm=Ger
DC	DC	PROPN	Number=Sing
risks	risk	NOUN	Number=Plur
details	detail	NOUN	Number=Plur
getting	get	VERB	Tense=Pres|VerbForm=Part
getting	get	AUX	VerbForm=Ger
getting	get	VERB	VerbForm=Ger
note	note	NOUN	Number=Sing
note	note	VERB	Mood=Imp|VerbForm=Fin
web	web	NOUN	Number=Sing
ARVN	ARVN	PROPN	Number=Sing
Larry	Larry	PROPN	Number=Sing
rabbit	rabbit	NOUN	Number=Sing
medical	medical	ADJ	Degree=Pos
ENRON.XLS	enron.xls	NOUN	Number=Sing
asking	ask	VERB	Tense=Pres|VerbForm=Part
asking	ask	VERB	VerbForm=Ger
able	able	ADJ	Degree=Pos
come	come	VERB	Mood=Ind|Tense=Pres|VerbForm=Fin
come	come	VERB	VerbForm=Inf
come	come	VERB	Tense=Past|VerbForm=Part
come	come	VERB	Mood=Imp|VerbForm=Fin
organizations	organization	NOUN	Number=Plur
happen	happen	VERB	VerbForm=Inf
flying	fly	VERB	VerbForm=Ger
international	international	ADJ	Degree=Pos
closing	closing	NOUN	Number=Sing
Bank	Bank	PROPN	Number=Sing
awarded	award	VERB	Tense=Past|VerbForm=Part
salsa	salsa	NOUN	Number=Sing
na	to	PART	Abbr=Yes
familiar	familiar	ADJ	Degree=Pos
YOUR	you	PRON	Person=2|Poss=Yes|PronType=Prs
British	british	ADJ	Degree=Pos
British	British	PROPN	Number=Sing
considering	consider	VERB	VerbForm=Ger
ECS	ECS	PROPN	Number=Sing
wolves	wolf	NOUN	Number=Plur
Climate	Climate	PROPN	Number=Sing
Law	Law	PROPN	Number=Sing
knows	know	VERB	Mood=Ind|Number=Sing|Person=3|Tense=Pres|VerbForm=Fin
impossible	impossible	ADJ	Degree=Pos
application	application	NOUN	Number=Sing
times	time	NOUN	Number=Plur
File	file	NOUN	Number=Sing
send	send	VERB	VerbForm=Inf
send	send	VERB	Mood=Ind|Tense=Pres|VerbForm=Fin
send	send	VERB	Mood=Imp|VerbForm=Fin
ticket	ticket	NOUN	Number=Sing
seen	see	VERB	Tense=Past|VerbForm=Part
seen	see	VERB	Tense=Past|VerbForm=Part|Voice=Pass
18	18	NUM	NumType=Card
moral	moral	ADJ	Degree=Pos
rays	ray	NOUN	Number=Plur
companies	company	NOUN	Number=Plur
When	when	ADV	PronType=Int
Hi	hi	INTJ	_
agreements	agreement	NOUN	Number=Plur
qualified	qualified	ADJ	Degree=Pos
European	european	ADJ	Degree=Pos
corporate	corporate	ADJ	Degree=Pos
share	share	VERB	VerbForm=Inf
Laurie	Laurie	PROPN	Number=Sing
car	car	NOUN	Number=Sing
organized	organized	ADJ	Degree=Pos
committee	committee	NOUN	Number=Sing
pie	pie	NOUN	Number=Sing
learned	learn	VERB	Mood=Ind|Tense=Past|VerbForm=Fin
prompt	prompt	ADJ	Degree=Pos
project	project	NOUN	Number=Sing
funding	funding	NOUN	Number=Sing
assigned	assign	VERB	Tense=Past|VerbForm=Part|Voice=Pass
history	history	NOUN	Number=Sing
anyway	anyway	ADV	_
ideas	idea	NOUN	Number=Plur
happening	happen	VERB	Tense=Pres|VerbForm=Part
action	action	NOUN	Number=Sing
leaving	leave	VERB	VerbForm=Ger
leaving	leave	VERB	Tense=Pres|VerbForm=Part
flights	flight	NOUN	Number=Plur
stuff	stuff	NOUN	Number=Sing
thus	thus	ADV	_
fault	fault	NOUN	Number=Sing
address	address	VERB	VerbForm=Inf
address	address	NOUN	Number=Sing
Sha'lan	Sha'lan	PROPN	Number=Sing
Renaissance	Renaissance	PROPN	Number=Sing
Iraq	Iraq	PROPN	Number=Sing
screen	screen	NOUN	Number=Sing
across	across	ADP	_
al	al	PROPN	Number=Sing
field	field	NOUN	Number=Sing
Call	call	VERB	Mood=Imp|VerbForm=Fin
economic	economic	ADJ	Degree=Pos
contract	contract	NOUN	Number=Sing
referred	refer	VERB	Tense=Past|VerbForm=Part
information	information	NOUN	Number=Sing
sender	sender	NOUN	Number=Sing
expand	expand	VERB	VerbForm=Inf
dollars	dollar	NOUN	Number=Plur
fairly	fairly	ADV	_
Yes	yes	INTJ	_
update	update	NOUN	Number=Sing
update	update	VERB	Mood=Imp|VerbForm=Fin
said	say	VERB	Mood=Ind|Tense=Past|VerbForm=Fin
said	say	VERB	Tense=Past|VerbForm=Part|Voice=Pass
said	say	VERB	Tense=Past|VerbForm=Part
gross	gross	ADJ	Degree=Pos
file	file	NOUN	Number=Sing
trot	trot	NOUN	Number=Sing
later	later	ADV	_
later	later	ADJ	Degree=Cmp
later	later	ADV	Degree=Cmp
board	board	NOUN	Number=Sing
requests	request	NOUN	Number=Plur
front	front	NOUN	Number=Sing
front	front	ADJ	Degree=Pos
sister	sister	NOUN	Number=Sing
birth	birth	NOUN	Number=Sing
where	where	ADV	PronType=Int
where	where	ADV	PronType=Rel
Boston	Boston	PROPN	Number=Sing
really	really	ADV	_
above	above	ADJ	Degree=Pos
above	above	ADP	_
above	above	ADV	_
Hurricane	Hurricane	PROPN	Number=Sing
P	p	NOUN	Number=Sing
26	26	NUM	NumType=Card
homes	home	NOUN	Number=Plur
recommend	recommend	VERB	Mood=Ind|Tense=Pres|VerbForm=Fin
recommend	recommend	VERB	VerbForm=Inf
sick	sick	ADJ	Degree=Pos
past	past	ADP	_
past	past	NOUN	Number=Sing
past	past	ADJ	Degree=Pos
roof	roof	NOUN	Number=Sing
three	three	NUM	NumType=Card
entering	enter	VERB	VerbForm=Ger
bother	bother	VERB	VerbForm=Inf
Fabio	Fabio	PROPN	Number=Sing
67	67	NUM	NumType=Card
Cell	cell	NOUN	Number=Sing
River	River	PROPN	Number=Sing
meetings	meeting	NOUN	Number=Plur
male	male	NOUN	Number=Sing
patient	patient	NOUN	Number=Sing
patient	patient	ADJ	Degree=Pos
Security	Security	PROPN	Number=Sing
pure	pure	ADJ	Degree=Pos
sushi	sushi	NOUN	Number=Sing
Abbas	Abbas	PROPN	Number=Sing
He	he	PRON	Case=Nom|Gender=Masc|Number=Sing|Person=3|PronType=Prs
cage	cage	NOUN	Number=Sing
Garden	Garden	PROPN	Number=Sing
protection	protection	NOUN	Number=Sing
Fujairah	Fujairah	PROPN	Number=Sing
laser	laser	NOUN	Number=Sing
Harry	Harry	PROPN	Number=Sing
waters	water	NOUN	Number=Plur
premium	premium	NOUN	Number=Sing
Florida	Florida	PROPN	Number=Sing
weapons	weapon	NOUN	Number=Plur
1561	1561	NUM	NumType=Card
5000	5000	NUM	NumType=Card
timing	timing	NOUN	Number=Sing
permit	permit	NOUN	Number=Sing
turn	turn	VERB	VerbForm=Inf
turn	turn	VERB	Mood=Ind|Tense=Pres|VerbForm=Fin
contact	contact	NOUN	Number=Sing
contact	contact	VERB	VerbForm=Inf
contact	contact	VERB	Mood=Imp|VerbForm=Fin
Now	now	ADV	_
plant	plant	NOUN	Number=Sing
fact	fact	NOUN	Number=Sing
Shaikh	Shaikh	PROPN	Number=Sing
ask	ask	VERB	VerbForm=Inf
ask	ask	VERB	Mood=Imp|VerbForm=Fin
ask	ask	VERB	Mood=Ind|Tense=Pres|VerbForm=Fin
Cindy	Cindy	PROPN	Number=Sing
Prophet	Prophet	PROPN	Number=Sing
any	any	ADV	_
any	any	DET	_
storm	storm	NOUN	Number=Sing
confidence	confidence	NOUN	Number=Sing
Overall	overall	ADV	_
Europe	Europe	PROPN	Number=Sing
dish	dish	NOUN	Number=Sing
Not	not	PART	_
Not	not	ADV	_
inquiries	inquiry	NOUN	Number=Plur
compensate	compensate	VERB	VerbForm=Inf
find	find	VERB	Mood=Imp|VerbForm=Fin
find	find	VERB	VerbForm=Inf
find	find	VERB	Mood=Ind|Tense=Pres|VerbForm=Fin
hearings	hearing	NOUN	Number=Plur
instructions	instruction	NOUN	Number=Plur
oil	oil	NOUN	Number=Sing
focus	focus	VERB	VerbForm=Inf
focus	focus	NOUN	Number=Sing
load	load	NOUN	Number=Sing
abuse	abuse	NOUN	Number=Sing
trail	trail	NOUN	Number=Sing
Instead	instead	ADV	_
6:30	6:30	NUM	NumType=Card
reconciliation	reconciliation	NOUN	Number=Sing
Beatles	Beatles	PROPN	Number=Plur
Allawi	Allawi	PROPN	Number=Sing
bombs	bomb	NOUN	Number=Plur
meantime	meantime	NOUN	Number=Sing
interests	interest	NOUN	Number=Plur
because	because	SCONJ	_
because	because	ADP	_
changes	change	NOUN	Number=Plur
owned	own	VERB	Tense=Past|VerbForm=Part
agenda	agenda	NOUN	Number=Sing
us	we	PRON	Case=Acc|Number=Plur|Person=1|PronType=Prs
angry	angry	ADJ	Degree=Pos
Defense	Defense	PROPN	Number=Sing
guy	guy	NOUN	Number=Sing
cash	cash	NOUN	Number=Sing
concerning	concern	VERB	VerbForm=Ger
allocated	allocate	VERB	Tense=Past|VerbForm=Part
Lopez	Lopez	PROPN	Number=Sing
Settlement	settlement	NOUN	Number=Sing
Ave	Ave	PROPN	Number=Sing
corners	corner	NOUN	Number=Plur
eating	eat	VERB	VerbForm=Ger
reading	read	VERB	VerbForm=Ger
culture	culture	NOUN	Number=Sing
500	500	NUM	NumType=Card
home	home	ADV	_
home	home	NOUN	Number=Sing
attended	attend	VERB	Tense=Past|VerbForm=Part
k	k	NOUN	Number=Sing
k	k	NUM	NumType=Card
Renee	Renee	PROPN	Number=Sing
panel	panel	NOUN	Number=Sing
charity	charity	NOUN	Number=Sing
Rhonda	Rhonda	PROPN	Number=Sing
sandwich	sandwich	NOUN	Number=Sing
personally	personally	ADV	_
Hotel	Hotel	PROPN	Number=Sing
Palestinian	palestinian	ADJ	Degree=Pos
consider	consider	VERB	VerbForm=Inf
consider	consider	VERB	Mood=Ind|Tense=Pres|VerbForm=Fin
Tet	Tet	PROPN	Number=Sing
cats	cat	NOUN	Number=Plur
sense	sense	NOUN	Number=Sing
gift	gift	NOUN	Number=Sing
regularly	regularly	ADV	_
silent	silent	ADJ	Degree=Pos
insurance	insurance	NOUN	Number=Sing
suicide	suicide	NOUN	Number=Sing
original	original	ADJ	Degree=Pos
leaves	leave	VERB	Mood=Ind|Number=Sing|Person=3|Tense=Pres|VerbForm=Fin
elsewhere	elsewhere	ADV	_
vast	vast	ADJ	Degree=Pos
fyi	fyi	ADV	_
skills	skill	NOUN	Number=Plur
games	game	NOUN	Number=Plur
]	]	PUNCT	_
wait	wait	VERB	VerbForm=Inf
wait	wait	NOUN	Number=Sing
wait	wait	VERB	Mood=Imp|VerbForm=Fin
Estimated	estimate	VERB	Tense=Past|VerbForm=Part
little	little	NOUN	Number=Sing
little	little	ADJ	Degree=Pos
little	little	ADV	Degree=Pos
THAT	that	PRON	Number=Sing|PronType=Dem
service	service	NOUN	Number=Sing
World	World	PROPN	Number=Sing
World	world	NOUN	Number=Sing
confirms	confirm	NOUN	Number=Plur
dumb	dumb	ADJ	Degree=Pos
crate	crate	NOUN	Number=Sing
activity	activity	NOUN	Number=Sing
charcoal	charcoal	NOUN	Number=Sing
sometime	sometime	ADV	_
perfect	perfect	ADJ	Degree=Pos
Actually	actually	ADV	_
gon	go	VERB	Abbr=Yes|Tense=Pres|VerbForm=Part
failure	failure	NOUN	Number=Sing
teams	team	NOUN	Number=Plur
incitement	incitement	NOUN	Number=Sing
Lay	Lay	PROPN	Number=Sing
John	John	PROPN	Number=Sing
someone	someone	PRON	Number=Sing
our	we	PRON	Number=Plur|Person=1|Poss=Yes|PronType=Prs
flavor	flavor	NOUN	Number=Sing
easiest	easiest	ADJ	Degree=Sup
capable	capable	ADJ	Degree=Pos
resistance	resistance	NOUN	Number=Sing
during	during	ADP	_
plastic	plastic	ADJ	Degree=Pos
realize	realize	VERB	Mood=Ind|Tense=Pres|VerbForm=Fin
realize	realize	VERB	VerbForm=Inf
next	next	ADJ	Degree=Pos
next	next	ADV	_
Amazing	amazing	ADJ	Degree=Pos
!?	!?	PUNCT	_
States	States	PROPN	Number=Sing
produce	produce	VERB	VerbForm=Inf
university	university	NOUN	Number=Sing
gotten	get	VERB	Tense=Past|VerbForm=Part
Sistani	Sistani	PROPN	Number=Sing
Laura	Laura	PROPN	Number=Sing
Instructor	instructor	NOUN	Number=Sing
ethnic	ethnic	ADJ	Degree=Pos
Martin	Martin	PROPN	Number=Sing
33	33	NUM	NumType=Card
in	in	NOUN	Number=Sing
in	in	ADV	_
in	in	SCONJ	_
in	in	ADP	_
men	man	NOUN	Number=Plur
remained	remain	VERB	Mood=Ind|Tense=Past|VerbForm=Fin
!!	!!	PUNCT	_
surgery	surgery	NOUN	Number=Sing
72	72	NUM	NumType=Card
County	County	PROPN	Number=Sing
habitat	habitat	NOUN	Number=Sing
1971	1971	NUM	NumType=Card
Has	have	AUX	Mood=Ind|Number=Sing|Person=3|Tense=Pres|VerbForm=Fin
welcoming	welcoming	ADJ	Degree=Pos
job	job	NOUN	Number=Sing
form	form	NOUN	Number=Sing
PLACE	place	NOUN	Number=Sing
personal	personal	ADJ	Degree=Pos
ultimate	ultimate	ADJ	Degree=Pos
blow	blow	VERB	VerbForm=Inf
Linda	Linda	PROPN	Number=Sing
broken	broken	ADJ	Degree=Pos
million	million	NUM	NumType=Card
Road	Road	PROPN	Number=Sing
Intelligence	Intelligence	PROPN	Number=Sing
main	main	ADJ	Degree=Pos
Worst	worst	ADJ	Degree=Sup
warm	warm	ADJ	Degree=Pos
GO	go	VERB	Mood=Imp|VerbForm=Fin
sorts	sort	NOUN	Number=Plur
hire	hire	VERB	VerbForm=Inf
warming	warming	NOUN	Number=Sing
100	100	NUM	NumType=Card
quoted	quote	VERB	Tense=Past|VerbForm=Part|Voice=Pass
electric	electric	ADJ	Degree=Pos
temperature	temperature	NOUN	Number=Sing
liberal	liberal	ADJ	Degree=Pos
lady	lady	NOUN	Number=Sing
mouth	mouth	NOUN	Number=Sing
compensation	compensation	NOUN	Number=Sing
changed	change	VERB	Tense=Past|VerbForm=Part
changed	change	VERB	Mood=Ind|Tense=Past|VerbForm=Fin
changed	change	VERB	Tense=Past|VerbForm=Part|Voice=Pass
9	9	NUM	NumType=Card
Enron	Enron	PROPN	Number=Sing
such	such	DET	_
such	such	ADJ	Degree=Pos
Have	have	AUX	Mood=Ind|Tense=Pres|VerbForm=Fin
Have	have	VERB	Mood=Ind|Tense=Pres|VerbForm=Fin
Have	have	VERB	Mood=Imp|VerbForm=Fin
cut	cut	VERB	Tense=Past|VerbForm=Part
cut	cut	NOUN	Number=Sing
cut	cut	VERB	Mood=Ind|Tense=Past|VerbForm=Fin
thinks	think	VERB	Mood=Ind|Number=Sing|Person=3|Tense=Pres|VerbForm=Fin
Dasovich	Dasovich	PROPN	Number=Sing
Province	Province	PROPN	Number=Sing
advance	advance	NOUN	Number=Sing
crop	crop	NOUN	Number=Sing
Chalabi	Chalabi	PROPN	Number=Sing
tax	tax	NOUN	Number=Sing
exam	exam	NOUN	Number=Sing
Inc	Inc	PROPN	Number=Sing
pocket	pocket	NOUN	Number=Sing
target	target	NOUN	Number=Sing
custom	custom	ADJ	Degree=Pos
1000	1000	NUM	NumType=Card
give	give	VERB	VerbForm=Inf
give	give	VERB	Mood=Ind|Tense=Pres|VerbForm=Fin
give	give	VERB	Mood=Imp|VerbForm=Fin
act	act	VERB	VerbForm=Inf
act	act	NOUN	Number=Sing
Otherwise	otherwise	ADV	_
dry	dry	ADJ	Degree=Pos
Download	download	NOUN	Number=Sing
Singapore	Singapore	PROPN	Number=Sing
tool	tool	NOUN	Number=Sing
Shiite	shiite	ADJ	Degree=Pos
supporting	support	VERB	VerbForm=Ger
customer	customer	NOUN	Number=Sing
selection	selection	NOUN	Number=Sing
flight	flight	NOUN	Number=Sing
riding	riding	NOUN	Number=Sing
planet	planet	NOUN	Number=Sing
naval	naval	ADJ	Degree=Pos
relatively	relatively	ADV	_
HR	hr	NOUN	Number=Sing
vet	vet	NOUN	Number=Sing
governor	governor	PROPN	Number=Sing
governor	governor	NOUN	Number=Sing
claims	claim	NOUN	Number=Plur
life	life	NOUN	Number=Sing
historical	historical	ADJ	Degree=Pos
ulterior	ulterior	ADJ	Degree=Pos
expanding	expand	VERB	VerbForm=Ger
specials	special	NOUN	Number=Plur
programs	program	NOUN	Number=Plur
final	final	ADJ	Degree=Pos
humanity	humanity	NOUN	Number=Sing
operating	operating	NOUN	Number=Sing
operating	operate	VERB	VerbForm=Ger
time	time	NOUN	Number=Sing
websites	website	NOUN	Number=Plur
fighter	fighter	NOUN	Number=Sing
WE	we	PRON	Case=Nom|Number=Plur|Person=1|PronType=Prs
~	~	PUNCT	_
occasions	occasion	NOUN	Number=Plur
tiny	tiny	ADJ	Degree=Pos
DF	DF	PROPN	Number=Sing
member	member	NOUN	Number=Sing
otherwise	otherwise	ADV	_
Everyone	everyone	PRON	Number=Sing
Recently	recently	ADV	_
relevant	relevant	ADJ	Degree=Pos
page	page	NOUN	Number=Sing
bin	bin	PROPN	Number=Sing
major	major	ADJ	Degree=Pos
teeth	tooth	NOUN	Number=Plur
cargo	cargo	NOUN	Number=Sing
truck	truck	NOUN	Number=Sing
prevent	prevent	VERB	VerbForm=Inf
Sounds	sound	VERB	Mood=Ind|Number=Sing|Person=3|Tense=Pres|VerbForm=Fin
fellow	fellow	ADJ	Degree=Pos
Hezbollah	Hezbollah	PROPN	Number=Sing
guns	gun	NOUN	Number=Plur
countries	country	NOUN	Number=Plur
another	another	DET	_
permanent	permanent	ADJ	Degree=Pos
metal	metal	NOUN	Number=Sing
Ayman	Ayman	PROPN	Number=Sing
specifically	specifically	ADV	_
hell	hell	NOUN	Number=Sing
officer	officer	NOUN	Number=Sing
assuming	assume	VERB	Tense=Pres|VerbForm=Part
Pew	Pew	PROPN	Number=Sing
but	but	ADP	_
but	but	CCONJ	_
popular	popular	ADJ	Degree=Pos
availability	availability	NOUN	Number=Sing
Sullivan	Sullivan	PROPN	Number=Sing
exact	exact	ADJ	Degree=Pos
fine	fine	ADV	_
fine	fine	ADJ	Degree=Pos
seeing	see	VERB	VerbForm=Ger
stand	stand	VERB	VerbForm=Inf
sets	set	VERB	Mood=Ind|Number=Sing|Person=3|Tense=Pres|VerbForm=Fin
authentic	authentic	ADJ	Degree=Pos
emissions	emission	NOUN	Number=Plur
how	how	ADV	PronType=Int
assistance	assistance	NOUN	Number=Sing
Action	Action	PROPN	Number=Sing
advise	advise	VERB	Mood=Imp|VerbForm=Fin
more	more	ADV	_
more	more	ADJ	Degree=Cmp
over	over	SCONJ	_
over	over	ADP	_
over	over	ADV	_
over	over	X	_
neighbours	neighbour	NOUN	Number=Plur
enjoying	enjoy	VERB	VerbForm=Ger
indication	indication	NOUN	Number=Sing
bronze	bronze	NOUN	Number=Sing
morning	morning	NOUN	Number=Sing
published	publish	VERB	Tense=Past|VerbForm=Part
England	England	PROPN	Number=Sing
Gerald	Gerald	PROPN	Number=Sing
Other	other	ADJ	Degree=Pos
Deb	Deb	PROPN	Number=Sing
Antonio	Antonio	PROPN	Number=Sing
tells	tell	VERB	Mood=Ind|Number=Sing|Person=3|Tense=Pres|VerbForm=Fin
task	task	NOUN	Number=Sing
tensions	tension	NOUN	Number=Plur
meet	meet	VERB	VerbForm=Inf
baby	baby	NOUN	Number=Sing
Questar	Questar	PROPN	Number=Sing
lawyer	lawyer	NOUN	Number=Sing
terrorist	terrorist	ADJ	Degree=Pos
terrorist	terrorist	NOUN	Number=Sing
detail	detail	NOUN	Number=Sing
if	if	SCONJ	_
strong	strong	ADJ	Degree=Pos
earned	earn	VERB	Mood=Ind|Tense=Past|VerbForm=Fin
email	email	NOUN	Number=Sing
email	email	VERB	VerbForm=Inf
intends	intend	VERB	Mood=Ind|Number=Sing|Person=3|Tense=Pres|VerbForm=Fin
questions	question	NOUN	Number=Plur
Further	further	ADV	_
shame	shame	NOUN	Number=Sing
American	American	PROPN	Number=Sing
American	american	ADJ	Degree=Pos
=	=	PUNCT	_
exactly	exactly	ADV	_
traffic	traffic	NOUN	Number=Sing
Admissions	admission	NOUN	Number=Plur
campaign	campaign	NOUN	Number=Sing
Portland	Portland	PROPN	Number=Sing
Yo	yo	PRON	_
reporter	reporter	NOUN	Number=Sing
gifts	gift	NOUN	Number=Plur
soil	soil	NOUN	Number=Sing
illegal	illegal	ADJ	Degree=Pos
conference	conference	NOUN	Number=Sing
system	system	NOUN	Number=Sing
pages	page	NOUN	Number=Plur
answered	answer	VERB	Mood=Ind|Tense=Past|VerbForm=Fin
decisions	decision	NOUN	Number=Plur
Rahu	Rahu	PROPN	Number=Sing
deep	deep	ADJ	Degree=Pos
guests	guest	NOUN	Number=Plur
pressure	pressure	NOUN	Number=Sing
moon	moon	NOUN	Number=Sing
caps	cap	NOUN	Number=Plur
Due	due	ADP	_
shops	shop	NOUN	Number=Plur
barrels	barrel	NOUN	Number=Plur
after	after	ADV	_
after	after	SCONJ	_
after	after	ADP	_
scale	scale	NOUN	Number=Sing
bank	bank	NOUN	Number=Sing
get	get	VERB	VerbForm=Inf
get	get	VERB	Mood=Imp|VerbForm=Fin
get	get	AUX	VerbForm=Inf
get	get	VERB	Mood=Ind|Tense=Pres|VerbForm=Fin
get	get	AUX	Mood=Ind|Tense=Pres|VerbForm=Fin
St.	St.	PROPN	Number=Sing
levels	level	NOUN	Number=Plur
practices	practice	NOUN	Number=Plur
proposal	proposal	NOUN	Number=Sing
things	thing	NOUN	Number=Plur
too	too	ADV	_
designed	design	VERB	Tense=Past|VerbForm=Part|Voice=Pass
designed	design	VERB	Tense=Past|VerbForm=Part
C	c	NOUN	Number=Sing
C	C	PROPN	Number=Sing
Website	website	NOUN	Number=Sing
!!!!	!!!!	PUNCT	_
Too	too	ADV	_
terrorism	terrorism	NOUN	Number=Sing
bedding	bedding	NOUN	Number=Sing
Saddam	Saddam	PROPN	Number=Sing
Spring	spring	NOUN	Number=Sing
pinkies	pinkie	NOUN	Number=Plur
Tehran	Tehran	PROPN	Number=Sing
lot	lot	NOUN	Number=Sing
electricity	electricity	NOUN	Number=Sing
anyone	anyone	PRON	Number=Sing
chiro	chiro	NOUN	Number=Sing
Checks	check	NOUN	Number=Plur
state	state	NOUN	Number=Sing
ISDA	ISDA	PROPN	Number=Sing
ISDA	isda	NOUN	Number=Sing
claimed	claim	VERB	Mood=Ind|Tense=Past|VerbForm=Fin
begun	begin	VERB	Tense=Past|VerbForm=Part
Sea	Sea	PROPN	Number=Sing
nuclear	nuclear	ADJ	Degree=Pos
hymn	hymn	NOUN	Number=Sing
separate	separate	ADJ	Degree=Pos
Support	support	NOUN	Number=Sing
Customer	customer	NOUN	Number=Sing
clan	clan	NOUN	Number=Sing
ENE	ENE	PROPN	Number=Sing
out	out	ADV	_
out	out	NOUN	Number=Sing
out	out	ADP	_
command	command	NOUN	Number=Sing
Sept.	Sept.	PROPN	Number=Sing
rights	rights	NOUN	Number=Plur
rain	rain	NOUN	Number=Sing
change	change	NOUN	Number=Sing
change	change	VERB	VerbForm=Inf
complaint	complaint	NOUN	Number=Sing
Internet	internet	NOUN	Number=Sing
death	death	NOUN	Number=Sing
100,000	100,000	NUM	NumType=Card
normal	normal	ADJ	Degree=Pos
substantial	substantial	ADJ	Degree=Pos
hit	hit	VERB	VerbForm=Inf
rep	rep	NOUN	Number=Sing
nearly	nearly	ADV	_
Midas	Midas	PROPN	Number=Sing
Canon	Canon	PROPN	Number=Sing
song	song	NOUN	Number=Sing
....	....	PUNCT	_
shoot	shoot	VERB	VerbForm=Inf
possibly	possibly	ADV	_
anniversary	anniversary	NOUN	Number=Sing
author	author	NOUN	Number=Sing
deaths	death	NOUN	Number=Plur
Base	base	NOUN	Number=Sing
per	per	ADP	_
per	per	NOUN	Number=Sing
storage	storage	NOUN	Number=Sing
available	available	ADJ	Degree=Pos
internet	internet	NOUN	Number=Sing
prepare	prepare	VERB	VerbForm=Inf
dishes	dish	NOUN	Number=Plur
stories	story	NOUN	Number=Plur
standing	stand	VERB	VerbForm=Ger
FBI	FBI	PROPN	Number=Sing
Molly	Molly	PROPN	Number=Sing
usually	usually	ADV	_
Given	give	VERB	Tense=Past|VerbForm=Part
legs	leg	NOUN	Number=Plur
II	II	PROPN	Number=Sing
II	ii	NUM	NumType=Card
income	income	NOUN	Number=Sing
somewhat	somewhat	ADV	_
55	55	NUM	NumType=Card
tired	tired	ADJ	Degree=Pos
publication	publication	NOUN	Number=Sing
ways	way	NOUN	Number=Plur
Or	or	CCONJ	_
discussed	discuss	VERB	Tense=Past|VerbForm=Part
discussed	discuss	VERB	Mood=Ind|Tense=Past|VerbForm=Fin
@	@	ADP	_
>	>	PUNCT	_
Asian	asian	ADJ	Degree=Pos
pair	pair	NOUN	Number=Sing
diplomacy	diplomacy	NOUN	Number=Sing
Oct	oct	X	_
Oct	Oct	PROPN	Number=Sing
calm	calm	ADJ	Degree=Pos
sorry	sorry	ADJ	Degree=Pos
sorry	sorry	INTJ	_
wonder	wonder	VERB	VerbForm=Inf
wonder	wonder	VERB	Mood=Ind|Tense=Pres|VerbForm=Fin
reasonable	reasonable	ADJ	Degree=Pos
last	last	VERB	VerbForm=Inf
last	last	ADJ	Degree=Pos
Abby	Abby	PROPN	Number=Sing
issued	issue	VERB	Mood=Ind|Tense=Past|VerbForm=Fin
issued	issue	VERB	Tense=Past|VerbForm=Part
THERE	there	PRON	_
THERE	there	ADV	PronType=Dem
lists	list	NOUN	Number=Plur
lists	list	VERB	Mood=Ind|Number=Sing|Person=3|Tense=Pres|VerbForm=Fin
toward	toward	ADP	_
East	East	PROPN	Number=Sing
future	future	NOUN	Number=Sing
future	future	ADJ	Degree=Pos
talked	talk	VERB	Mood=Ind|Tense=Past|VerbForm=Fin
talked	talk	VERB	Tense=Past|VerbForm=Part
bathroom	bathroom	NOUN	Number=Sing
So	so	ADV	_
late	late	ADJ	Degree=Pos
late	late	ADV	Degree=Pos
entirely	entirely	ADV	_
713	713	NUM	NumType=Card
venture	venture	NOUN	Number=Sing
bright	bright	ADJ	Degree=Pos
wish	wish	VERB	Mood=Ind|Tense=Pres|VerbForm=Fin
pieces	piece	NOUN	Number=Plur
payment	payment	NOUN	Number=Sing
Meiring	Meiring	PROPN	Number=Sing
Transmission	transmission	X	_
base	base	NOUN	Number=Sing
duty	duty	NOUN	Number=Sing
Minister	Minister	PROPN	Number=Sing
Two	two	NUM	NumType=Card
spots	spot	NOUN	Number=Plur
Italian	italian	ADJ	Degree=Pos
Saudi	saudi	ADJ	Degree=Pos
Saudi	Saudi	PROPN	Number=Sing
society	society	NOUN	Number=Sing
virtually	virtually	ADV	_
nail	nail	NOUN	Number=Sing
Coalition	Coalition	PROPN	Number=Sing
influence	influence	NOUN	Number=Sing
consistent	consistent	ADJ	Degree=Pos
blank	blank	ADJ	Degree=Pos
Alliance	Alliance	PROPN	Number=Sing
Excellent	excellent	ADJ	Degree=Pos
be	be	AUX	Mood=Imp|VerbForm=Fin
be	be	VERB	VerbForm=Inf
be	be	AUX	VerbForm=Inf
facilities	facility	NOUN	Number=Plur
Payment	payment	NOUN	Number=Sing
area	area	NOUN	Number=Sing
atmosphere	atmosphere	NOUN	Number=Sing
Doctor	Doctor	PROPN	Number=Sing
rules	rule	NOUN	Number=Plur
their	they	PRON	Number=Plur|Person=3|Poss=Yes|PronType=Prs
overpriced	overpriced	ADJ	Degree=Pos
713-646-3393	713-646-3393	NUM	NumType=Card
yeah	yeah	INTJ	_
aspects	aspect	NOUN	Number=Plur
afternoon	afternoon	NOUN	Number=Sing
lived	live	VERB	Mood=Ind|Tense=Past|VerbForm=Fin
lived	live	VERB	Tense=Past|VerbForm=Part
Western	western	ADJ	Degree=Pos
borders	border	NOUN	Number=Plur
success	success	NOUN	Number=Sing
typically	typically	ADV	_
reason	reason	NOUN	Number=Sing
army	army	NOUN	Number=Sing
reduce	reduce	VERB	VerbForm=Inf
calls	call	NOUN	Number=Plur
calls	call	VERB	Mood=Ind|Number=Sing|Person=3|Tense=Pres|VerbForm=Fin
created	create	VERB	Mood=Ind|Tense=Past|VerbForm=Fin
created	create	VERB	Tense=Past|VerbForm=Part
cross	cross	NOUN	Number=Sing
Australia	Australia	PROPN	Number=Sing
Groups	group	NOUN	Number=Plur
announcement	announcement	NOUN	Number=Sing
rule	rule	NOUN	Number=Sing
billions	billion	NOUN	Number=Plur
design	design	NOUN	Number=Sing
steak	steak	NOUN	Number=Sing
dental	dental	ADJ	Degree=Pos
ID	id	NOUN	Number=Sing
suggest	suggest	VERB	VerbForm=Inf
suggest	suggest	VERB	Mood=Ind|Tense=Pres|VerbForm=Fin
haircut	haircut	NOUN	Number=Sing
â€œ	"	PUNCT	_
resulted	result	VERB	Tense=Past|VerbForm=Part
start	start	VERB	Mood=Ind|Tense=Pres|VerbForm=Fin
start	start	VERB	VerbForm=Inf
start	start	NOUN	Number=Sing
're	be	AUX	Mood=Ind|Tense=Pres|VerbForm=Fin
responsibility	responsibility	NOUN	Number=Sing
famous	famous	ADJ	Degree=Pos
skilled	skilled	ADJ	Degree=Pos
fall	fall	NOUN	Number=Sing
fall	fall	VERB	VerbForm=Inf
Top	top	ADJ	Degree=Pos
May	May	PROPN	Number=Sing
dominate	dominate	ADJ	Degree=Pos
They	they	PRON	Case=Nom|Number=Plur|Person=3|PronType=Prs
under	under	ADP	_
booked	book	VERB	Tense=Past|VerbForm=Part
booked	book	VERB	Mood=Ind|Tense=Past|VerbForm=Fin
booked	book	VERB	Tense=Past|VerbForm=Part|Voice=Pass
Group	Group	PROPN	Number=Sing
Group	group	NOUN	Number=Sing
ARCHIBALD	ARCHIBALD	PROPN	Number=Sing
Stones	Stones	PROPN	Number=Plur
PEREZ	PEREZ	PROPN	Number=Sing
mistake	mistake	NOUN	Number=Sing
Thomas	Thomas	PROPN	Number=Sing
crazy	crazy	ADJ	Degree=Pos
joined	join	VERB	Mood=Ind|Tense=Past|VerbForm=Fin
cozy	cozy	ADJ	Degree=Pos
face	face	VERB	VerbForm=Inf
face	face	NOUN	Number=Sing
moderate	moderate	ADJ	Degree=Pos
Good	good	ADJ	Degree=Pos
visited	visit	VERB	Mood=Ind|Tense=Past|VerbForm=Fin
visited	visit	VERB	Tense=Past|VerbForm=Part
calling	call	VERB	VerbForm=Ger
calling	call	VERB	Tense=Pres|VerbForm=Part
Best	best	ADJ	Degree=Sup
She	she	PRON	Case=Nom|Gender=Fem|Number=Sing|Person=3|PronType=Prs
ensure	ensure	VERB	VerbForm=Inf
Net	Net	PROPN	Number=Sing
Yeah	yeah	INTJ	_
climb	climb	VERB	VerbForm=Inf
policies	policy	NOUN	Number=Plur
handling	handle	VERB	Tense=Pres|VerbForm=Part
handling	handle	VERB	VerbForm=Ger
this	this	DET	Number=Sing|PronType=Dem
this	this	PRON	Number=Sing|PronType=Dem
this	this	ADV	_
won	win	VERB	Mood=Ind|Tense=Past|VerbForm=Fin
Patty	Patty	PROPN	Number=Sing
ice	ice	NOUN	Number=Sing
determined	determined	ADJ	Degree=Pos
grab	grab	VERB	VerbForm=Inf
wave	wave	NOUN	Number=Sing
driver	driver	NOUN	Number=Sing
predators	predator	NOUN	Number=Plur
negative	negative	ADJ	Degree=Pos
example	example	NOUN	Number=Sing
restaurant	restaurant	NOUN	Number=Sing
Global	Global	PROPN	Number=Sing
Global	global	ADJ	Degree=Pos
useful	useful	ADJ	Degree=Pos
comment	comment	NOUN	Number=Sing
fair	fair	ADJ	Degree=Pos
attitude	attitude	NOUN	Number=Sing
GREAT	great	ADJ	Degree=Pos
involving	involve	VERB	VerbForm=Ger
like	like	VERB	VerbForm=Inf
like	like	INTJ	_
like	like	SCONJ	_
like	like	ADP	_
like	like	ADJ	Degree=Pos
like	like	VERB	Mood=Ind|Tense=Pres|VerbForm=Fin
|	|	SYM	_
appropriations	appropriation	NOUN	Number=Plur
dad	dad	NOUN	Number=Sing
spicy	spicy	ADJ	Degree=Pos
worked	work	VERB	Mood=Ind|Tense=Past|VerbForm=Fin
worked	work	VERB	Tense=Past|VerbForm=Part
style	style	NOUN	Number=Sing
longer	longer	ADV	Degree=Cmp
noon	noon	NOUN	Number=Sing
TW	TW	PROPN	Number=Sing
From	from	ADP	_
astronauts	astronaut	NOUN	Number=Plur
thousands	thousand	NOUN	Number=Plur
pays	pay	VERB	Mood=Ind|Number=Sing|Person=3|Tense=Pres|VerbForm=Fin
rock	rock	NOUN	Number=Sing
cages	cage	NOUN	Number=Plur
crucial	crucial	ADJ	Degree=Pos
toes	toe	NOUN	Number=Plur
basis	basis	NOUN	Number=Sing
default	default	NOUN	Number=Sing
32	32	NUM	NumType=Card
village	village	NOUN	Number=Sing
Friendly	friendly	ADJ	Degree=Pos
heavily	heavily	ADV	_
likes	like	VERB	Mood=Ind|Number=Sing|Person=3|Tense=Pres|VerbForm=Fin
confidentiality	confidentiality	NOUN	Number=Sing
book	book	VERB	VerbForm=Inf
book	book	NOUN	Number=Sing
racial	racial	ADJ	Degree=Pos
majority	majority	NOUN	Number=Sing
allowed	allow	VERB	Tense=Past|VerbForm=Part
allowed	allow	VERB	Tense=Past|VerbForm=Part|Voice=Pass
Non-Bondad	non-bondad	NOUN	Number=Sing
already	already	ADV	_
B	b	ADJ	Degree=Pos
B	b	NOUN	Number=Sing
B	B	PROPN	Number=Sing
delete	delete	VERB	Mood=Imp|VerbForm=Fin
unpopular	unpopular	ADJ	Degree=Pos
lbs	lb	NOUN	Number=Plur
american	american	ADJ	Degree=Pos
associated	associate	VERB	Tense=Past|VerbForm=Part
......	......	PUNCT	_
Wednesday	Wednesday	PROPN	Number=Sing
NYC	NYC	PROPN	Number=Sing
interconnect	interconnect	NOUN	Number=Sing
amazing	amazing	ADJ	Degree=Pos
merely	merely	ADV	_
benefits	benefit	NOUN	Number=Plur
Paulo	Paulo	PROPN	Number=Sing
Arab	arab	ADJ	Degree=Pos
years	year	NOUN	Number=Plur
Zealand	Zealand	PROPN	Number=Sing
pm	pm	NOUN	Number=Sing
Great	great	ADJ	Degree=Pos
operator	operator	NOUN	Number=Sing
fifty	fifty	NUM	NumType=Card
piece	piece	NOUN	Number=Sing
intelligence	intelligence	NOUN	Number=Sing
explanation	explanation	NOUN	Number=Sing
what	what	DET	PronType=Int
what	what	PRON	PronType=Int
failed	fail	VERB	Mood=Ind|Tense=Past|VerbForm=Fin
arrive	arrive	VERB	Mood=Ind|Tense=Pres|VerbForm=Fin
never	never	ADV	_
loved	love	VERB	Mood=Ind|Tense=Past|VerbForm=Fin
businesses	business	NOUN	Number=Plur
deal	deal	VERB	VerbForm=Inf
deal	deal	NOUN	Number=Sing
5	5	NUM	NumType=Card
acquiring	acquire	VERB	VerbForm=Ger
is	be	VERB	Mood=Ind|Number=Sing|Person=3|Tense=Pres|VerbForm=Fin
is	be	AUX	Mood=Ind|Number=Sing|Person=3|Tense=Pres|VerbForm=Fin
w	with	ADP	Abbr=Yes
34	34	NUM	NumType=Card
chest	chest	NOUN	Number=Sing
girl	girl	NOUN	Number=Sing
Staff	staff	NOUN	Number=Sing
security	security	NOUN	Number=Sing
Steve	Steve	PROPN	Number=Sing
documentation	documentation	NOUN	Number=Sing
Judge	judge	NOUN	Number=Sing
newspaper	newspaper	NOUN	Number=Sing
10,000	10,000	NUM	NumType=Card
top	top	ADJ	Degree=Pos
top	top	NOUN	Number=Sing
complex	complex	NOUN	Number=Sing
watch	watch	VERB	VerbForm=Inf
better	better	ADV	Degree=Cmp
better	better	ADJ	Degree=Cmp
Ted	Ted	PROPN	Number=Sing
pet	pet	NOUN	Number=Sing
fit	fit	VERB	VerbForm=Inf
entry	entry	NOUN	Number=Sing
inspection	inspection	NOUN	Number=Sing
network	network	NOUN	Number=Sing
Fall	fall	NOUN	Number=Sing
memo	memo	NOUN	Number=Sing
walk	walk	NOUN	Number=Sing
walk	walk	VERB	VerbForm=Inf
walk	walk	VERB	Mood=Imp|VerbForm=Fin
do	do	VERB	Mood=Imp|VerbForm=Fin
do	do	AUX	Mood=Imp|VerbForm=Fin
do	do	VERB	Mood=Ind|Tense=Pres|VerbForm=Fin
do	do	VERB	VerbForm=Inf
do	do	AUX	Mood=Ind|Tense=Pres|VerbForm=Fin
do	do	AUX	VerbForm=Inf
remains	remain	VERB	Mood=Ind|Number=Sing|Person=3|Tense=Pres|VerbForm=Fin
SOLAS	SOLAS	PROPN	Number=Sing
serve	serve	VERB	VerbForm=Inf
2:30	2:30	NUM	NumType=Card
write	write	VERB	VerbForm=Inf
Rick	Rick	PROPN	Number=Sing
theory	theory	NOUN	Number=Sing
mid	mid	X	_
lobster	lobster	NOUN	Number=Sing
voicemail	voicemail	NOUN	Number=Sing
pizza	pizza	NOUN	Number=Sing
SHE	she	PRON	Case=Nom|Gender=Fem|Number=Sing|Person=3|PronType=Prs
blanket	blanket	NOUN	Number=Sing
France	France	PROPN	Number=Sing
manage	manage	VERB	VerbForm=Inf
chicken	chicken	NOUN	Number=Sing
government	government	NOUN	Number=Sing
05/25/2001	05/25/2001	NUM	NumType=Card
salad	salad	NOUN	Number=Sing
moving	move	VERB	VerbForm=Ger
moving	move	VERB	Tense=Pres|VerbForm=Part
support	support	NOUN	Number=Sing
support	support	VERB	VerbForm=Inf
substantially	substantially	ADV	_
furniture	furniture	NOUN	Number=Sing
.......	.......	PUNCT	_
corporation	corporation	NOUN	Number=Sing
soldiers	soldier	NOUN	Number=Plur
Iraqis	Iraqis	PROPN	Number=Plur
decline	decline	VERB	VerbForm=Inf
decline	decline	NOUN	Number=Sing
It	it	PRON	Case=Nom|Gender=Neut|Number=Sing|Person=3|PronType=Prs
feed	feed	NOUN	Number=Sing
feed	feed	VERB	Mood=Ind|Tense=Pres|VerbForm=Fin
feed	feed	VERB	Mood=Imp|VerbForm=Fin
feed	feed	VERB	VerbForm=Inf
enjoy	enjoy	VERB	VerbForm=Inf
enjoy	enjoy	VERB	Mood=Ind|Tense=Pres|VerbForm=Fin
cream	cream	NOUN	Number=Sing
happens	happen	VERB	Mood=Ind|Number=Sing|Person=3|Tense=Pres|VerbForm=Fin
simultaneously	simultaneously	ADV	_
green	green	ADJ	Degree=Pos
immediately	immediately	ADV	_
eastern	eastern	ADJ	Degree=Pos
set	set	VERB	Tense=Past|VerbForm=Part|Voice=Pass
set	set	VERB	VerbForm=Inf
set	set	NOUN	Number=Sing
set	set	VERB	Tense=Past|VerbForm=Part
set	set	ADJ	Degree=Pos
!	!	PUNCT	_
take	take	VERB	Mood=Imp|VerbForm=Fin
take	take	VERB	VerbForm=Inf
take	take	VERB	Mood=Ind|Tense=Pres|VerbForm=Fin
take	take	NOUN	Number=Sing
monitor	monitor	VERB	VerbForm=Inf
tap	tap	NOUN	Number=Sing
Council	Council	PROPN	Number=Sing
anything	anything	PRON	Number=Sing
artistic	artistic	ADJ	Degree=Pos
p	p	NOUN	Number=Sing
shopping	shopping	NOUN	Number=Sing
Saturday	Saturday	PROPN	Number=Sing
Ms.	Ms.	PROPN	Number=Sing
mainly	mainly	ADV	_
Stay	stay	VERB	VerbForm=Inf
Stay	stay	VERB	Mood=Imp|VerbForm=Fin
heavy	heavy	ADJ	Degree=Pos
forth	forth	ADV	_
Star	Star	PROPN	Number=Sing
Manager	manager	NOUN	Number=Sing
Egypt	Egypt	PROPN	Number=Sing
decided	decide	VERB	Tense=Past|VerbForm=Part
decided	decide	VERB	Mood=Ind|Tense=Past|VerbForm=Fin
except	except	ADP	_
seconds	seconds	NOUN	Number=Plur
without	without	SCONJ	_
without	without	ADP	_
cruel	cruel	ADJ	Degree=Pos
Just	just	ADV	_
extremely	extremely	ADV	_
looks	look	VERB	Mood=Ind|Number=Sing|Person=3|Tense=Pres|VerbForm=Fin
against	against	ADP	_
Board	board	NOUN	Number=Sing
confirmed	confirm	VERB	Tense=Past|VerbForm=Part
confirmed	confirm	VERB	Mood=Ind|Tense=Past|VerbForm=Fin
Another	another	DET	_
pain	pain	NOUN	Number=Sing
manufacturer	manufacturer	NOUN	Number=Sing
See	see	VERB	Mood=Imp|VerbForm=Fin
jury	jury	NOUN	Number=Sing
eye	eye	NOUN	Number=Sing
products	product	NOUN	Number=Plur
plus	plus	CCONJ	_
lights	light	NOUN	Number=Plur
Section	section	NOUN	Number=Sing
2005	2005	NUM	NumType=Card
education	education	NOUN	Number=Sing
went	go	VERB	Mood=Ind|Tense=Past|VerbForm=Fin
king	king	NOUN	Number=Sing
3889	3889	NUM	NumType=Card
ahead	ahead	ADV	_
Zaman	Zaman	PROPN	Number=Sing
hey	hey	INTJ	_
:	:	PUNCT	_
result	result	NOUN	Number=Sing
spray	spray	NOUN	Number=Sing
Transaction	transaction	NOUN	Number=Sing
attach	attach	VERB	VerbForm=Inf
goal	goal	NOUN	Number=Sing
enovate	enovate	NOUN	Number=Sing
.?	.?	PUNCT	_
recommendation	recommendation	NOUN	Number=Sing
W.	W.	PROPN	Number=Sing
regard	regard	NOUN	Number=Sing
double	double	ADJ	Degree=Pos
nation	nation	NOUN	Number=Sing
limited	limited	ADJ	Degree=Pos
half	half	NOUN	Number=Sing
half	half	DET	_
half	half	ADJ	Degree=Pos
expected	expect	VERB	Mood=Ind|Tense=Past|VerbForm=Fin
14	14	NUM	NumType=Card
let	let	VERB	VerbForm=Inf
let	let	VERB	Mood=Imp|VerbForm=Fin
let	let	VERB	Mood=Ind|Tense=Past|VerbForm=Fin
Columbia	Columbia	PROPN	Number=Sing
Forum	Forum	PROPN	Number=Sing
Fallujah	Fallujah	PROPN	Number=Sing
worms	worm	NOUN	Number=Plur
Myanmar	Myanmar	PROPN	Number=Sing
adjust	adjust	VERB	VerbForm=Inf
print	print	VERB	Mood=Imp|VerbForm=Fin
bet	bet	NOUN	Number=Sing
successfully	successfully	ADV	_
Comments	comment	NOUN	Number=Plur
NJ	NJ	PROPN	Number=Sing
radiation	radiation	NOUN	Number=Sing
market	market	NOUN	Number=Sing
Team	team	NOUN	Number=Sing
talks	talk	NOUN	Number=Plur
decide	decide	VERB	VerbForm=Inf
decide	decide	VERB	Mood=Ind|Tense=Pres|VerbForm=Fin
brings	bring	VERB	Mood=Ind|Number=Sing|Person=3|Tense=Pres|VerbForm=Fin
development	development	NOUN	Number=Sing
impressive	impressive	ADJ	Degree=Pos
has	have	VERB	Mood=Ind|Number=Sing|Person=3|Tense=Pres|VerbForm=Fin
has	have	AUX	Mood=Ind|Number=Sing|Person=3|Tense=Pres|VerbForm=Fin
energy	energy	NOUN	Number=Sing
season	season	NOUN	Number=Sing
Communists	Communists	PROPN	Number=Plur
ship	ship	NOUN	Number=Sing
Me	I	PRON	Case=Acc|Number=Sing|Person=1|PronType=Prs
NY	NY	PROPN	Number=Sing
rats	rat	NOUN	Number=Plur
region	region	NOUN	Number=Sing
As	as	ADP	_
As	as	ADV	_
As	as	SCONJ	_
super	super	ADV	_
hesitate	hesitate	VERB	VerbForm=Inf
hesitate	hesitate	VERB	Mood=Imp|VerbForm=Fin
UVB	uvb	NOUN	Number=Sing
healthy	healthy	ADJ	Degree=Pos
Does	do	AUX	Mood=Ind|Number=Sing|Person=3|Tense=Pres|VerbForm=Fin
MMBTU	mmbtu	NOUN	Number=Plur
OF	of	ADP	_
Birds	bird	NOUN	Number=Plur
conversations	conversation	NOUN	Number=Plur
known	know	VERB	Tense=Past|VerbForm=Part
known	know	VERB	Tense=Past|VerbForm=Part|Voice=Pass
Merchanting	Merchanting	PROPN	Number=Sing
god	god	PROPN	Number=Sing
refers	refer	VERB	Mood=Ind|Number=Sing|Person=3|Tense=Pres|VerbForm=Fin
islands	island	NOUN	Number=Plur
Jack	Jack	PROPN	Number=Sing
management	management	NOUN	Number=Sing
wondering	wonder	VERB	VerbForm=Ger
wondering	wonder	VERB	Tense=Pres|VerbForm=Part
citizens	citizen	NOUN	Number=Plur
sign	sign	NOUN	Number=Sing
sign	sign	VERB	VerbForm=Inf
2002	2002	NUM	NumType=Card
followed	follow	VERB	Mood=Ind|Tense=Past|VerbForm=Fin
restaurants	restaurant	NOUN	Number=Plur
Thank	thank	VERB	Mood=Ind|Tense=Pres|VerbForm=Fin
beer	beer	NOUN	Number=Sing
floor	floor	NOUN	Number=Sing
:D	:d	SYM	_
2:00	2:00	NUM	NumType=Card
usual	usual	ADJ	Degree=Pos
120	120	NUM	NumType=Card
Aafia	Aafia	PROPN	Number=Sing
writing	write	VERB	VerbForm=Ger
writing	writing	NOUN	Number=Sing
